bc_wells,sample,species,gene_count,tscp_count,mread_count,GRCm39_gene_count,GRCm39_tscp_count,GRCm39_mread_count,hg38_gene_count,hg38_tscp_count,hg38_mread_count,bc1_wind,bc2_wind,bc3_wind,bc1_well,bc2_well,bc3_well
01_01_37,xcond_1,GRCm39,420,588,964,419,586,958,1,2,6,1,1,37,A1,A1,D1
01_01_62,xcond_1,GRCm39,986,1845,3000,984,1842,2997,2,3,3,1,1,62,A1,A1,F2
01_01_69,xcond_1,GRCm39,192,257,398,192,257,398,0,0,0,1,1,69,A1,A1,F9
01_01_85,xcond_1,GRCm39,580,865,1400,579,864,1399,1,1,1,1,1,85,A1,A1,H1
01_02_08,xcond_1,GRCm39,535,841,1392,535,841,1392,0,0,0,1,2,8,A1,A2,A8
01_02_61,xcond_1,GRCm39,826,1457,2441,824,1453,2433,2,4,8,1,2,61,A1,A2,F1
01_02_66,xcond_1,GRCm39,480,677,1098,479,676,1097,1,1,1,1,2,66,A1,A2,F6
01_02_69,xcond_1,GRCm39,531,867,1432,530,866,1431,1,1,1,1,2,69,A1,A2,F9
01_02_76,xcond_1,GRCm39,724,1069,1698,724,1069,1698,0,0,0,1,2,76,A1,A2,G4
01_02_86,xcond_1,GRCm39,667,1001,1667,667,1001,1667,0,0,0,1,2,86,A1,A2,H2
01_03_40,xcond_1,GRCm39,1141,1836,2952,1139,1831,2945,2,5,7,1,3,40,A1,A3,D4
01_03_52,xcond_1,GRCm39,537,772,1187,537,772,1187,0,0,0,1,3,52,A1,A3,E4
01_03_79,xcond_1,GRCm39,624,858,1426,623,857,1423,1,1,3,1,3,79,A1,A3,G7
01_03_84,xcond_1,GRCm39,346,427,695,345,426,694,1,1,1,1,3,84,A1,A3,G12
01_04_26,xcond_1,GRCm39,292,420,685,292,420,685,0,0,0,1,4,26,A1,A4,C2
01_04_74,xcond_1,GRCm39,932,1734,2764,930,1732,2760,2,2,4,1,4,74,A1,A4,G2
01_05_03,xcond_1,GRCm39,170,208,308,170,208,308,0,0,0,1,5,3,A1,A5,A3
01_05_43,xcond_1,GRCm39,1078,2559,4133,1076,2557,4131,2,2,2,1,5,43,A1,A5,D7
01_05_50,xcond_1,GRCm39,1273,1984,3281,1271,1982,3277,2,2,4,1,5,50,A1,A5,E2
01_05_63,xcond_1,GRCm39,364,553,874,364,553,874,0,0,0,1,5,63,A1,A5,F3
01_06_07,xcond_1,GRCm39,412,517,855,411,516,854,1,1,1,1,6,7,A1,A6,A7
01_06_11,xcond_1,GRCm39,2129,4654,7519,2125,4646,7509,4,8,10,1,6,11,A1,A6,A11
01_06_17,xcond_1,GRCm39,621,979,1541,619,977,1538,2,2,3,1,6,17,A1,A6,B5
01_07_13,xcond_1,GRCm39,422,565,954,421,564,952,1,1,2,1,7,13,A1,A7,B1
01_07_43,xcond_1,GRCm39,223,277,444,222,276,443,1,1,1,1,7,43,A1,A7,D7
01_07_93,xcond_1,GRCm39,254,336,555,253,335,554,1,1,1,1,7,93,A1,A7,H9
01_08_51,xcond_1,GRCm39,617,862,1428,617,862,1428,0,0,0,1,8,51,A1,A8,E3
01_08_57,xcond_1,GRCm39,214,259,395,214,259,395,0,0,0,1,8,57,A1,A8,E9
01_08_72,xcond_1,GRCm39,1276,2044,3454,1273,2037,3440,3,7,14,1,8,72,A1,A8,F12
01_08_80,xcond_1,GRCm39,558,683,1134,556,681,1131,2,2,3,1,8,80,A1,A8,G8
01_08_81,xcond_1,GRCm39,595,905,1462,595,905,1462,0,0,0,1,8,81,A1,A8,G9
01_08_85,xcond_1,GRCm39,850,1362,2217,850,1362,2217,0,0,0,1,8,85,A1,A8,H1
01_08_92,xcond_1,GRCm39,921,1489,2441,920,1488,2440,1,1,1,1,8,92,A1,A8,H8
01_09_36,xcond_1,GRCm39,1270,2150,3361,1269,2149,3360,1,1,1,1,9,36,A1,A9,C12
01_09_93,xcond_1,GRCm39,481,727,1168,481,727,1168,0,0,0,1,9,93,A1,A9,H9
01_10_12,xcond_1,GRCm39,642,930,1502,640,928,1496,2,2,6,1,10,12,A1,A10,A12
01_10_20,xcond_1,GRCm39,422,556,907,422,556,907,0,0,0,1,10,20,A1,A10,B8
01_10_85,xcond_1,GRCm39,484,670,1082,484,670,1082,0,0,0,1,10,85,A1,A10,H1
01_10_91,xcond_1,GRCm39,689,1043,1768,688,1042,1767,1,1,1,1,10,91,A1,A10,H7
01_11_50,xcond_1,GRCm39,677,1096,1772,676,1095,1771,1,1,1,1,11,50,A1,A11,E2
01_12_43,xcond_1,GRCm39,836,1415,2318,832,1411,2308,4,4,10,1,12,43,A1,A12,D7
01_12_47,xcond_1,GRCm39,1351,2150,3598,1350,2148,3596,1,2,2,1,12,47,A1,A12,D11
01_12_86,xcond_1,GRCm39,243,320,504,243,320,504,0,0,0,1,12,86,A1,A12,H2
01_12_92,xcond_1,GRCm39,175,209,352,175,209,352,0,0,0,1,12,92,A1,A12,H8
01_12_93,xcond_1,GRCm39,472,681,1091,470,679,1085,2,2,6,1,12,93,A1,A12,H9
01_13_08,xcond_1,GRCm39,853,1434,2295,851,1430,2288,2,4,7,1,13,8,A1,B1,A8
01_13_12,xcond_1,GRCm39,2068,4321,7075,2068,4321,7075,0,0,0,1,13,12,A1,B1,A12
01_13_36,xcond_1,GRCm39,754,1848,2986,753,1847,2985,1,1,1,1,13,36,A1,B1,C12
01_13_42,xcond_1,GRCm39,606,964,1467,606,964,1467,0,0,0,1,13,42,A1,B1,D6
01_13_62,xcond_1,GRCm39,446,580,912,446,580,912,0,0,0,1,13,62,A1,B1,F2
01_13_74,xcond_1,GRCm39,772,1196,1941,771,1195,1940,1,1,1,1,13,74,A1,B1,G2
01_13_78,xcond_1,GRCm39,4879,16507,27009,4875,16498,26992,4,9,17,1,13,78,A1,B1,G6
01_13_79,xcond_1,GRCm39,506,695,1156,506,695,1156,0,0,0,1,13,79,A1,B1,G7
01_13_80,xcond_1,GRCm39,821,1513,2475,820,1512,2474,1,1,1,1,13,80,A1,B1,G8
01_13_89,xcond_1,GRCm39,207,250,414,207,250,414,0,0,0,1,13,89,A1,B1,H5
01_14_19,xcond_1,GRCm39,912,1591,2630,911,1590,2629,1,1,1,1,14,19,A1,B2,B7
01_14_63,xcond_1,GRCm39,1206,2013,3452,1205,2012,3451,1,1,1,1,14,63,A1,B2,F3
01_15_03,xcond_1,GRCm39,243,295,466,243,295,466,0,0,0,1,15,3,A1,B3,A3
01_15_23,xcond_1,GRCm39,672,1081,1760,671,1080,1759,1,1,1,1,15,23,A1,B3,B11
01_15_48,xcond_1,GRCm39,364,527,825,363,526,824,1,1,1,1,15,48,A1,B3,D12
01_15_84,xcond_1,GRCm39,563,764,1246,562,763,1245,1,1,1,1,15,84,A1,B3,G12
01_16_21,xcond_1,GRCm39,297,390,682,297,390,682,0,0,0,1,16,21,A1,B4,B9
01_16_33,xcond_1,GRCm39,238,315,543,237,314,542,1,1,1,1,16,33,A1,B4,C9
01_16_64,xcond_1,GRCm39,246,317,456,245,316,455,1,1,1,1,16,64,A1,B4,F4
01_17_38,xcond_1,GRCm39,790,1234,2072,789,1233,2071,1,1,1,1,17,38,A1,B5,D2
01_17_84,xcond_1,GRCm39,576,796,1343,575,795,1342,1,1,1,1,17,84,A1,B5,G12
01_17_92,xcond_1,GRCm39,309,431,699,307,428,694,2,3,5,1,17,92,A1,B5,H8
01_18_15,xcond_1,GRCm39,996,1802,2953,994,1797,2945,2,5,8,1,18,15,A1,B6,B3
01_18_24,xcond_1,GRCm39,851,1398,2240,850,1397,2238,1,1,2,1,18,24,A1,B6,B12
01_18_26,xcond_1,GRCm39,736,1175,1896,735,1174,1894,1,1,2,1,18,26,A1,B6,C2
01_18_45,xcond_1,GRCm39,683,873,1416,681,871,1414,2,2,2,1,18,45,A1,B6,D9
01_19_20,xcond_1,GRCm39,1136,1776,2903,1135,1772,2892,1,4,11,1,19,20,A1,B7,B8
01_19_26,xcond_1,GRCm39,959,1478,2384,957,1476,2382,2,2,2,1,19,26,A1,B7,C2
01_19_30,xcond_1,GRCm39,313,395,630,312,394,627,1,1,3,1,19,30,A1,B7,C6
01_19_35,xcond_1,GRCm39,188,342,544,188,342,544,0,0,0,1,19,35,A1,B7,C11
01_19_56,xcond_1,GRCm39,545,848,1346,544,847,1344,1,1,2,1,19,56,A1,B7,E8
01_19_72,xcond_1,GRCm39,334,401,632,334,401,632,0,0,0,1,19,72,A1,B7,F12
01_19_79,xcond_1,GRCm39,655,1022,1679,652,1019,1676,3,3,3,1,19,79,A1,B7,G7
01_20_08,xcond_1,GRCm39,225,284,436,225,284,436,0,0,0,1,20,8,A1,B8,A8
01_20_16,xcond_1,GRCm39,929,1579,2512,928,1577,2509,1,2,3,1,20,16,A1,B8,B4
01_20_26,xcond_1,GRCm39,1705,2984,4732,1703,2982,4728,2,2,4,1,20,26,A1,B8,C2
01_20_30,xcond_1,GRCm39,1685,2922,4621,1685,2922,4621,0,0,0,1,20,30,A1,B8,C6
01_20_37,xcond_1,GRCm39,319,618,995,318,617,994,1,1,1,1,20,37,A1,B8,D1
01_20_77,xcond_1,GRCm39,615,876,1395,613,874,1393,2,2,2,1,20,77,A1,B8,G5
01_20_84,xcond_1,GRCm39,987,1864,3029,985,1862,3025,2,2,4,1,20,84,A1,B8,G12
01_21_08,xcond_1,GRCm39,779,1245,2010,779,1245,2010,0,0,0,1,21,8,A1,B9,A8
01_21_33,xcond_1,GRCm39,371,542,943,370,541,940,1,1,3,1,21,33,A1,B9,C9
01_21_45,xcond_1,GRCm39,1116,1755,2901,1115,1754,2900,1,1,1,1,21,45,A1,B9,D9
01_21_71,xcond_1,GRCm39,201,241,399,199,239,397,2,2,2,1,21,71,A1,B9,F11
01_22_06,xcond_1,GRCm39,979,1714,2800,977,1712,2798,2,2,2,1,22,6,A1,B10,A6
01_22_31,xcond_1,GRCm39,1461,2743,4468,1459,2741,4465,2,2,3,1,22,31,A1,B10,C7
01_22_77,xcond_1,GRCm39,599,898,1484,599,898,1484,0,0,0,1,22,77,A1,B10,G5
01_22_84,xcond_1,GRCm39,4318,14049,23113,4312,14033,23089,6,16,24,1,22,84,A1,B10,G12
01_22_95,xcond_1,GRCm39,2171,4279,7180,2169,4277,7176,2,2,4,1,22,95,A1,B10,H11
01_23_69,xcond_1,GRCm39,495,665,1078,494,664,1076,1,1,2,1,23,69,A1,B11,F9
01_24_20,xcond_1,GRCm39,594,896,1502,594,896,1502,0,0,0,1,24,20,A1,B12,B8
01_24_23,xcond_1,GRCm39,534,824,1370,533,823,1369,1,1,1,1,24,23,A1,B12,B11
01_24_65,xcond_1,GRCm39,1216,2384,3919,1213,2381,3913,3,3,6,1,24,65,A1,B12,F5
01_24_84,xcond_1,GRCm39,1392,2725,4506,1392,2725,4506,0,0,0,1,24,84,A1,B12,G12
01_24_89,xcond_1,GRCm39,865,1358,2176,865,1358,2176,0,0,0,1,24,89,A1,B12,H5
01_25_96,xcond_1,GRCm39,503,801,1329,503,801,1329,0,0,0,1,25,96,A1,C1,H12
01_26_42,xcond_1,GRCm39,646,1002,1568,646,1002,1568,0,0,0,1,26,42,A1,C2,D6
01_26_66,xcond_1,GRCm39,210,255,431,210,255,431,0,0,0,1,26,66,A1,C2,F6
01_26_81,xcond_1,GRCm39,422,579,956,420,577,954,2,2,2,1,26,81,A1,C2,G9
01_27_20,xcond_1,GRCm39,240,332,532,240,332,532,0,0,0,1,27,20,A1,C3,B8
01_27_25,xcond_1,GRCm39,313,411,652,313,411,652,0,0,0,1,27,25,A1,C3,C1
01_27_27,xcond_1,GRCm39,4825,16281,26332,4817,16263,26307,8,18,25,1,27,27,A1,C3,C3
01_27_63,xcond_1,GRCm39,382,546,843,381,545,842,1,1,1,1,27,63,A1,C3,F3
01_27_68,xcond_1,GRCm39,417,533,877,416,532,876,1,1,1,1,27,68,A1,C3,F8
01_27_93,xcond_1,GRCm39,525,881,1389,524,880,1388,1,1,1,1,27,93,A1,C3,H9
01_27_95,xcond_1,GRCm39,345,435,707,343,432,702,2,3,5,1,27,95,A1,C3,H11
01_28_02,xcond_1,GRCm39,2672,5218,8602,2669,5213,8594,3,5,8,1,28,2,A1,C4,A2
01_28_20,xcond_1,GRCm39,935,1600,2615,934,1599,2614,1,1,1,1,28,20,A1,C4,B8
01_28_21,xcond_1,GRCm39,2326,4804,7811,2325,4803,7810,1,1,1,1,28,21,A1,C4,B9
01_28_30,xcond_1,GRCm39,152,435,687,152,435,687,0,0,0,1,28,30,A1,C4,C6
01_28_59,xcond_1,GRCm39,370,550,818,370,550,818,0,0,0,1,28,59,A1,C4,E11
01_28_90,xcond_1,GRCm39,1047,1598,2626,1046,1597,2624,1,1,2,1,28,90,A1,C4,H6
01_29_05,xcond_1,GRCm39,539,749,1240,537,746,1236,2,3,4,1,29,5,A1,C5,A5
01_29_35,xcond_1,GRCm39,764,1115,1882,764,1115,1882,0,0,0,1,29,35,A1,C5,C11
01_29_48,xcond_1,GRCm39,817,1445,2370,816,1443,2367,1,2,3,1,29,48,A1,C5,D12
01_29_57,xcond_1,GRCm39,189,263,422,189,263,422,0,0,0,1,29,57,A1,C5,E9
01_29_96,xcond_1,GRCm39,589,967,1653,588,965,1650,1,2,3,1,29,96,A1,C5,H12
01_30_08,xcond_1,GRCm39,216,257,402,215,256,401,1,1,1,1,30,8,A1,C6,A8
01_30_26,xcond_1,GRCm39,145,212,342,145,212,342,0,0,0,1,30,26,A1,C6,C2
01_30_42,xcond_1,GRCm39,570,922,1479,570,922,1479,0,0,0,1,30,42,A1,C6,D6
01_30_61,xcond_1,GRCm39,723,1265,2066,723,1265,2066,0,0,0,1,30,61,A1,C6,F1
01_30_63,xcond_1,GRCm39,441,956,1528,441,956,1528,0,0,0,1,30,63,A1,C6,F3
01_30_83,xcond_1,GRCm39,181,218,338,181,218,338,0,0,0,1,30,83,A1,C6,G11
01_31_25,xcond_1,GRCm39,302,374,612,302,374,612,0,0,0,1,31,25,A1,C7,C1
01_31_72,xcond_1,GRCm39,149,352,533,148,351,532,1,1,1,1,31,72,A1,C7,F12
01_31_73,xcond_1,GRCm39,1100,2026,3333,1099,2025,3331,1,1,2,1,31,73,A1,C7,G1
01_31_78,xcond_1,GRCm39,1465,2867,4616,1465,2867,4616,0,0,0,1,31,78,A1,C7,G6
01_31_96,xcond_1,GRCm39,200,426,692,200,426,692,0,0,0,1,31,96,A1,C7,H12
01_32_48,xcond_1,GRCm39,516,837,1361,515,836,1359,1,1,2,1,32,48,A1,C8,D12
01_32_84,xcond_1,GRCm39,261,317,471,261,317,471,0,0,0,1,32,84,A1,C8,G12
01_33_18,xcond_1,GRCm39,514,693,1150,514,693,1150,0,0,0,1,33,18,A1,C9,B6
01_33_24,xcond_1,GRCm39,263,605,968,263,605,968,0,0,0,1,33,24,A1,C9,B12
01_33_54,xcond_1,GRCm39,281,363,576,281,363,576,0,0,0,1,33,54,A1,C9,E6
01_33_59,xcond_1,GRCm39,741,1139,1843,738,1135,1839,3,4,4,1,33,59,A1,C9,E11
01_33_67,xcond_1,GRCm39,1205,2279,3642,1202,2275,3638,3,4,4,1,33,67,A1,C9,F7
01_33_76,xcond_1,GRCm39,809,1349,2202,808,1348,2201,1,1,1,1,33,76,A1,C9,G4
01_33_86,xcond_1,GRCm39,549,863,1455,548,861,1452,1,2,3,1,33,86,A1,C9,H2
01_34_31,xcond_1,GRCm39,673,1030,1664,672,1028,1662,1,2,2,1,34,31,A1,C10,C7
01_34_67,xcond_1,GRCm39,3244,7713,12669,3240,7707,12661,4,6,8,1,34,67,A1,C10,F7
01_34_73,xcond_1,GRCm39,672,948,1578,670,945,1574,2,3,4,1,34,73,A1,C10,G1
01_34_77,xcond_1,GRCm39,378,638,1041,377,637,1040,1,1,1,1,34,77,A1,C10,G5
01_35_77,xcond_1,GRCm39,638,891,1400,637,890,1399,1,1,1,1,35,77,A1,C11,G5
01_36_03,xcond_1,GRCm39,656,882,1374,656,882,1374,0,0,0,1,36,3,A1,C12,A3
01_36_14,xcond_1,GRCm39,569,783,1252,568,782,1251,1,1,1,1,36,14,A1,C12,B2
01_36_20,xcond_1,GRCm39,716,1142,1753,715,1141,1751,1,1,2,1,36,20,A1,C12,B8
01_36_21,xcond_1,GRCm39,216,249,308,216,249,308,0,0,0,1,36,21,A1,C12,B9
01_36_33,xcond_1,GRCm39,190,230,285,189,229,284,1,1,1,1,36,33,A1,C12,C9
01_36_41,xcond_1,GRCm39,1821,3283,5126,1818,3280,5123,3,3,3,1,36,41,A1,C12,D5
01_36_47,xcond_1,GRCm39,854,1261,1963,852,1258,1958,2,3,5,1,36,47,A1,C12,D11
01_36_52,xcond_1,GRCm39,8497,62468,100243,8484,62413,100167,13,55,76,1,36,52,A1,C12,E4
01_36_57,xcond_1,GRCm39,657,947,1461,657,947,1461,0,0,0,1,36,57,A1,C12,E9
01_36_63,xcond_1,GRCm39,434,552,849,434,552,849,0,0,0,1,36,63,A1,C12,F3
01_36_81,xcond_1,GRCm39,765,1059,1630,763,1057,1626,2,2,4,1,36,81,A1,C12,G9
01_36_84,xcond_1,GRCm39,183,223,298,183,223,298,0,0,0,1,36,84,A1,C12,G12
01_36_88,xcond_1,GRCm39,866,1325,2081,866,1325,2081,0,0,0,1,36,88,A1,C12,H4
01_37_33,xcond_1,GRCm39,255,359,607,254,358,606,1,1,1,1,37,33,A1,D1,C9
01_37_35,xcond_1,GRCm39,669,1118,1879,669,1118,1879,0,0,0,1,37,35,A1,D1,C11
01_37_45,xcond_1,GRCm39,222,305,505,222,305,505,0,0,0,1,37,45,A1,D1,D9
01_37_60,xcond_1,GRCm39,555,899,1483,555,899,1483,0,0,0,1,37,60,A1,D1,E12
01_37_61,xcond_1,GRCm39,509,798,1275,508,797,1274,1,1,1,1,37,61,A1,D1,F1
01_37_68,xcond_1,GRCm39,1770,3384,5600,1768,3381,5593,2,3,7,1,37,68,A1,D1,F8
01_37_96,xcond_1,GRCm39,338,452,718,338,452,718,0,0,0,1,37,96,A1,D1,H12
01_38_15,xcond_1,GRCm39,513,689,1184,512,688,1182,1,1,2,1,38,15,A1,D2,B3
01_38_72,xcond_1,GRCm39,272,366,585,272,366,585,0,0,0,1,38,72,A1,D2,F12
01_38_81,xcond_1,GRCm39,186,221,378,186,221,378,0,0,0,1,38,81,A1,D2,G9
01_38_91,xcond_1,GRCm39,406,583,942,406,583,942,0,0,0,1,38,91,A1,D2,H7
01_39_21,xcond_1,GRCm39,649,829,1310,649,829,1310,0,0,0,1,39,21,A1,D3,B9
01_39_63,xcond_1,GRCm39,1643,3606,5717,1643,3606,5717,0,0,0,1,39,63,A1,D3,F3
01_40_04,xcond_1,GRCm39,1329,2324,3838,1325,2320,3834,4,4,4,1,40,4,A1,D4,A4
01_40_25,xcond_1,GRCm39,352,477,742,351,476,740,1,1,2,1,40,25,A1,D4,C1
01_40_43,xcond_1,GRCm39,716,1171,1955,716,1171,1955,0,0,0,1,40,43,A1,D4,D7
01_40_48,xcond_1,GRCm39,614,964,1631,614,964,1631,0,0,0,1,40,48,A1,D4,D12
01_40_59,xcond_1,GRCm39,2326,4876,8007,2324,4872,7999,2,4,8,1,40,59,A1,D4,E11
01_40_72,xcond_1,GRCm39,676,1032,1735,675,1031,1734,1,1,1,1,40,72,A1,D4,F12
01_40_74,xcond_1,GRCm39,3074,7590,12748,3071,7587,12743,3,3,5,1,40,74,A1,D4,G2
01_40_78,xcond_1,GRCm39,780,1220,2002,778,1217,1998,2,3,4,1,40,78,A1,D4,G6
01_41_03,xcond_1,GRCm39,1522,2401,4065,1519,2397,4059,3,4,6,1,41,3,A1,D5,A3
01_41_08,xcond_1,GRCm39,163,221,350,163,221,350,0,0,0,1,41,8,A1,D5,A8
01_41_32,xcond_1,GRCm39,707,977,1653,707,977,1653,0,0,0,1,41,32,A1,D5,C8
01_41_49,xcond_1,GRCm39,124,256,363,123,255,362,1,1,1,1,41,49,A1,D5,E1
01_41_60,xcond_1,GRCm39,1721,3914,6333,1719,3910,6328,2,4,5,1,41,60,A1,D5,E12
01_41_66,xcond_1,GRCm39,183,214,354,182,213,353,1,1,1,1,41,66,A1,D5,F6
01_41_81,xcond_1,GRCm39,280,349,597,280,349,597,0,0,0,1,41,81,A1,D5,G9
01_41_83,xcond_1,GRCm39,534,771,1285,532,767,1281,2,4,4,1,41,83,A1,D5,G11
01_41_93,xcond_1,GRCm39,434,818,1316,434,818,1316,0,0,0,1,41,93,A1,D5,H9
01_41_96,xcond_1,GRCm39,937,1477,2470,936,1476,2468,1,1,2,1,41,96,A1,D5,H12
01_42_08,xcond_1,GRCm39,433,607,974,432,606,973,1,1,1,1,42,8,A1,D6,A8
01_42_13,xcond_1,GRCm39,1050,2164,3456,1049,2161,3449,1,3,7,1,42,13,A1,D6,B1
01_42_30,xcond_1,GRCm39,581,924,1479,581,924,1479,0,0,0,1,42,30,A1,D6,C6
01_42_45,xcond_1,GRCm39,354,434,730,353,433,729,1,1,1,1,42,45,A1,D6,D9
01_42_62,xcond_1,GRCm39,650,931,1530,647,928,1522,3,3,8,1,42,62,A1,D6,F2
01_42_79,xcond_1,GRCm39,249,350,560,249,350,560,0,0,0,1,42,79,A1,D6,G7
01_43_36,xcond_1,GRCm39,635,1049,1657,633,1046,1652,2,3,5,1,43,36,A1,D7,C12
01_43_62,xcond_1,GRCm39,333,534,881,333,534,881,0,0,0,1,43,62,A1,D7,F2
01_43_72,xcond_1,GRCm39,661,1062,1819,659,1060,1815,2,2,4,1,43,72,A1,D7,F12
01_43_77,xcond_1,GRCm39,238,302,513,238,302,513,0,0,0,1,43,77,A1,D7,G5
01_43_92,xcond_1,GRCm39,801,1339,2190,800,1338,2189,1,1,1,1,43,92,A1,D7,H8
01_44_11,xcond_1,GRCm39,594,962,1495,594,962,1495,0,0,0,1,44,11,A1,D8,A11
01_44_25,xcond_1,GRCm39,527,780,1219,525,777,1216,2,3,3,1,44,25,A1,D8,C1
01_44_51,xcond_1,GRCm39,322,446,705,322,446,705,0,0,0,1,44,51,A1,D8,E3
01_45_18,xcond_1,GRCm39,670,2141,3479,669,2140,3478,1,1,1,1,45,18,A1,D9,B6
01_45_66,xcond_1,GRCm39,451,679,1097,451,679,1097,0,0,0,1,45,66,A1,D9,F6
01_45_81,xcond_1,GRCm39,410,615,1021,410,615,1021,0,0,0,1,45,81,A1,D9,G9
01_46_20,xcond_1,GRCm39,1236,1915,3176,1235,1914,3174,1,1,2,1,46,20,A1,D10,B8
01_46_28,xcond_1,GRCm39,450,649,1000,450,649,1000,0,0,0,1,46,28,A1,D10,C4
01_46_39,xcond_1,GRCm39,718,1183,1947,717,1182,1946,1,1,1,1,46,39,A1,D10,D3
01_46_60,xcond_1,GRCm39,952,1357,2227,952,1357,2227,0,0,0,1,46,60,A1,D10,E12
01_47_27,xcond_1,GRCm39,255,329,519,255,329,519,0,0,0,1,47,27,A1,D11,C3
01_47_30,xcond_1,GRCm39,2096,4097,6730,2093,4093,6716,3,4,14,1,47,30,A1,D11,C6
01_47_48,xcond_1,GRCm39,876,1425,2294,875,1424,2293,1,1,1,1,47,48,A1,D11,D12
01_47_71,xcond_1,GRCm39,889,1444,2253,887,1442,2249,2,2,4,1,47,71,A1,D11,F11
01_47_83,xcond_1,GRCm39,1426,2592,4176,1425,2591,4175,1,1,1,1,47,83,A1,D11,G11
01_48_15,xcond_1,GRCm39,1155,2277,3667,1153,2275,3663,2,2,4,1,48,15,A1,D12,B3
01_48_24,xcond_1,GRCm39,640,1018,1639,639,1017,1637,1,1,2,1,48,24,A1,D12,B12
01_48_25,xcond_1,GRCm39,950,1453,2371,950,1453,2371,0,0,0,1,48,25,A1,D12,C1
01_48_52,xcond_1,GRCm39,1149,2569,4189,1146,2565,4181,3,4,8,1,48,52,A1,D12,E4
01_48_57,xcond_1,GRCm39,355,491,803,354,490,802,1,1,1,1,48,57,A1,D12,E9
01_48_80,xcond_1,GRCm39,1106,2055,3352,1105,2054,3351,1,1,1,1,48,80,A1,D12,G8
01_48_84,xcond_1,GRCm39,765,1141,1883,764,1140,1882,1,1,1,1,48,84,A1,D12,G12
01_48_93,xcond_1,GRCm39,418,748,1203,418,748,1203,0,0,0,1,48,93,A1,D12,H9
01_48_96,xcond_1,GRCm39,508,705,1157,508,705,1157,0,0,0,1,48,96,A1,D12,H12
01_49_36,xcond_1,GRCm39,1207,1928,3176,1206,1927,3174,1,1,2,1,49,36,A1,E1,C12
01_49_42,xcond_1,GRCm39,669,1065,1767,669,1065,1767,0,0,0,1,49,42,A1,E1,D6
01_49_52,xcond_1,GRCm39,410,571,924,410,571,924,0,0,0,1,49,52,A1,E1,E4
01_49_69,xcond_1,GRCm39,392,547,861,391,545,858,1,2,3,1,49,69,A1,E1,F9
01_49_92,xcond_1,GRCm39,740,1212,2005,739,1211,2003,1,1,2,1,49,92,A1,E1,H8
01_50_36,xcond_1,GRCm39,890,1309,2130,889,1305,2122,1,4,8,1,50,36,A1,E2,C12
01_50_41,xcond_1,GRCm39,2958,7023,11293,2954,7017,11283,4,6,10,1,50,41,A1,E2,D5
01_50_72,xcond_1,GRCm39,1372,2373,3920,1370,2370,3917,2,3,3,1,50,72,A1,E2,F12
01_51_21,xcond_1,GRCm39,1085,1781,2987,1085,1781,2987,0,0,0,1,51,21,A1,E3,B9
01_51_35,xcond_1,GRCm39,672,1165,1852,671,1164,1851,1,1,1,1,51,35,A1,E3,C11
01_51_43,xcond_1,GRCm39,589,1119,1826,589,1119,1826,0,0,0,1,51,43,A1,E3,D7
01_52_23,xcond_1,GRCm39,489,808,1305,489,808,1305,0,0,0,1,52,23,A1,E4,B11
01_52_39,xcond_1,GRCm39,1571,2774,4502,1570,2773,4501,1,1,1,1,52,39,A1,E4,D3
01_52_45,xcond_1,GRCm39,381,625,1007,381,625,1007,0,0,0,1,52,45,A1,E4,D9
01_52_69,xcond_1,GRCm39,767,1338,2173,766,1337,2172,1,1,1,1,52,69,A1,E4,F9
01_52_84,xcond_1,GRCm39,594,1121,1807,593,1120,1804,1,1,3,1,52,84,A1,E4,G12
01_52_86,xcond_1,GRCm39,371,494,819,371,494,819,0,0,0,1,52,86,A1,E4,H2
01_52_92,xcond_1,GRCm39,491,664,1095,490,662,1090,1,2,5,1,52,92,A1,E4,H8
01_53_07,xcond_1,GRCm39,588,919,1449,586,916,1442,2,3,7,1,53,7,A1,E5,A7
01_53_19,xcond_1,GRCm39,284,358,579,283,357,578,1,1,1,1,53,19,A1,E5,B7
01_53_41,xcond_1,GRCm39,308,401,660,308,401,660,0,0,0,1,53,41,A1,E5,D5
01_53_55,xcond_1,GRCm39,676,1242,2035,674,1240,2032,2,2,3,1,53,55,A1,E5,E7
01_53_87,xcond_1,GRCm39,251,292,485,251,292,485,0,0,0,1,53,87,A1,E5,H3
01_53_88,xcond_1,GRCm39,2314,4622,7633,2311,4616,7626,3,6,7,1,53,88,A1,E5,H4
01_53_93,xcond_1,GRCm39,290,390,650,289,389,649,1,1,1,1,53,93,A1,E5,H9
01_54_41,xcond_1,GRCm39,4814,15257,25422,4808,15243,25399,6,14,23,1,54,41,A1,E6,D5
01_54_59,xcond_1,GRCm39,722,1103,1801,721,1101,1799,1,2,2,1,54,59,A1,E6,E11
01_54_62,xcond_1,GRCm39,258,292,510,258,292,510,0,0,0,1,54,62,A1,E6,F2
01_54_77,xcond_1,GRCm39,756,1668,2709,755,1667,2708,1,1,1,1,54,77,A1,E6,G5
01_54_86,xcond_1,GRCm39,945,1438,2324,944,1436,2322,1,2,2,1,54,86,A1,E6,H2
01_54_88,xcond_1,GRCm39,873,1562,2572,872,1561,2571,1,1,1,1,54,88,A1,E6,H4
01_55_41,xcond_1,GRCm39,273,387,643,273,387,643,0,0,0,1,55,41,A1,E7,D5
01_55_66,xcond_1,GRCm39,249,284,456,249,284,456,0,0,0,1,55,66,A1,E7,F6
01_55_68,xcond_1,GRCm39,340,434,754,339,432,751,1,2,3,1,55,68,A1,E7,F8
01_55_80,xcond_1,GRCm39,271,355,587,271,355,587,0,0,0,1,55,80,A1,E7,G8
01_56_50,xcond_1,GRCm39,745,1254,2100,742,1250,2095,3,4,5,1,56,50,A1,E8,E2
01_56_56,xcond_1,GRCm39,272,463,773,271,462,772,1,1,1,1,56,56,A1,E8,E8
01_56_59,xcond_1,GRCm39,222,283,456,222,283,456,0,0,0,1,56,59,A1,E8,E11
01_57_03,xcond_1,GRCm39,1187,1918,3205,1186,1917,3204,1,1,1,1,57,3,A1,E9,A3
01_57_15,xcond_1,GRCm39,1021,1891,3164,1021,1891,3164,0,0,0,1,57,15,A1,E9,B3
01_57_38,xcond_1,GRCm39,837,1523,2495,833,1517,2489,4,6,6,1,57,38,A1,E9,D2
01_57_48,xcond_1,GRCm39,1151,2239,3644,1150,2238,3643,1,1,1,1,57,48,A1,E9,D12
01_57_61,xcond_1,GRCm39,1996,4518,7392,1994,4516,7385,2,2,7,1,57,61,A1,E9,F1
01_57_64,xcond_1,GRCm39,367,550,895,367,550,895,0,0,0,1,57,64,A1,E9,F4
01_57_69,xcond_1,GRCm39,931,1388,2288,930,1387,2287,1,1,1,1,57,69,A1,E9,F9
01_57_84,xcond_1,GRCm39,862,1302,2133,862,1302,2133,0,0,0,1,57,84,A1,E9,G12
01_58_12,xcond_1,GRCm39,1222,1910,3179,1220,1908,3177,2,2,2,1,58,12,A1,E10,A12
01_58_16,xcond_1,GRCm39,154,209,285,154,209,285,0,0,0,1,58,16,A1,E10,B4
01_58_43,xcond_1,GRCm39,749,1076,1743,749,1076,1743,0,0,0,1,58,43,A1,E10,D7
01_58_51,xcond_1,GRCm39,1125,1919,3109,1124,1918,3108,1,1,1,1,58,51,A1,E10,E3
01_58_90,xcond_1,GRCm39,4130,13429,22177,4126,13420,22160,4,9,17,1,58,90,A1,E10,H6
01_59_37,xcond_1,GRCm39,403,709,1118,403,709,1118,0,0,0,1,59,37,A1,E11,D1
01_59_55,xcond_1,GRCm39,2141,4875,7973,2140,4874,7972,1,1,1,1,59,55,A1,E11,E7
01_59_57,xcond_1,GRCm39,2770,6529,10564,2766,6520,10550,4,9,14,1,59,57,A1,E11,E9
01_59_79,xcond_1,GRCm39,851,1410,2246,849,1407,2240,2,3,6,1,59,79,A1,E11,G7
01_60_71,xcond_1,GRCm39,394,503,829,392,501,826,2,2,3,1,60,71,A1,E12,F11
01_60_81,xcond_1,GRCm39,695,1389,2355,695,1389,2355,0,0,0,1,60,81,A1,E12,G9
01_61_14,xcond_1,GRCm39,962,1708,2780,961,1706,2776,1,2,4,1,61,14,A1,F1,B2
01_62_01,xcond_1,GRCm39,323,404,711,322,403,710,1,1,1,1,62,1,A1,F2,A1
01_62_14,xcond_1,GRCm39,423,554,952,422,553,951,1,1,1,1,62,14,A1,F2,B2
01_62_16,xcond_1,GRCm39,188,226,354,188,226,354,0,0,0,1,62,16,A1,F2,B4
01_62_33,xcond_1,GRCm39,437,531,894,437,531,894,0,0,0,1,62,33,A1,F2,C9
01_62_38,xcond_1,GRCm39,880,1519,2554,880,1519,2554,0,0,0,1,62,38,A1,F2,D2
01_62_42,xcond_1,GRCm39,605,835,1359,603,833,1357,2,2,2,1,62,42,A1,F2,D6
01_62_45,xcond_1,GRCm39,221,247,428,221,247,428,0,0,0,1,62,45,A1,F2,D9
01_62_90,xcond_1,GRCm39,602,865,1421,602,865,1421,0,0,0,1,62,90,A1,F2,H6
01_63_19,xcond_1,GRCm39,1079,1773,2920,1078,1772,2919,1,1,1,1,63,19,A1,F3,B7
01_63_72,xcond_1,GRCm39,993,1851,3123,992,1850,3122,1,1,1,1,63,72,A1,F3,F12
01_63_84,xcond_1,GRCm39,1519,3537,5896,1518,3536,5895,1,1,1,1,63,84,A1,F3,G12
01_63_88,xcond_1,GRCm39,1693,3204,5314,1691,3201,5309,2,3,5,1,63,88,A1,F3,H4
01_63_96,xcond_1,GRCm39,391,483,784,391,483,784,0,0,0,1,63,96,A1,F3,H12
01_64_04,xcond_1,GRCm39,1035,2106,3417,1033,2104,3415,2,2,2,1,64,4,A1,F4,A4
01_64_36,xcond_1,GRCm39,495,727,1163,495,727,1163,0,0,0,1,64,36,A1,F4,C12
01_64_38,xcond_1,GRCm39,897,1438,2421,896,1436,2416,1,2,5,1,64,38,A1,F4,D2
01_64_39,xcond_1,GRCm39,3053,6976,11536,3050,6970,11522,3,6,14,1,64,39,A1,F4,D3
01_64_45,xcond_1,GRCm39,443,565,918,442,564,917,1,1,1,1,64,45,A1,F4,D9
01_64_63,xcond_1,GRCm39,938,1742,2828,936,1739,2824,2,3,4,1,64,63,A1,F4,F3
01_64_64,xcond_1,GRCm39,452,641,1035,451,640,1034,1,1,1,1,64,64,A1,F4,F4
01_64_73,xcond_1,GRCm39,462,651,1063,461,650,1062,1,1,1,1,64,73,A1,F4,G1
01_64_79,xcond_1,GRCm39,1240,2168,3679,1239,2167,3676,1,1,3,1,64,79,A1,F4,G7
01_66_01,xcond_1,GRCm39,427,588,1015,427,588,1015,0,0,0,1,66,1,A1,F6,A1
01_66_02,xcond_1,GRCm39,2997,11365,19122,2993,11354,19106,4,11,16,1,66,2,A1,F6,A2
01_66_06,xcond_1,GRCm39,643,938,1613,641,936,1609,2,2,4,1,66,6,A1,F6,A6
01_66_62,xcond_1,GRCm39,600,949,1635,600,949,1635,0,0,0,1,66,62,A1,F6,F2
01_66_63,xcond_1,GRCm39,1420,3074,5251,1418,3071,5246,2,3,5,1,66,63,A1,F6,F3
01_66_90,xcond_1,GRCm39,310,400,646,310,400,646,0,0,0,1,66,90,A1,F6,H6
01_66_93,xcond_1,GRCm39,178,210,363,178,210,363,0,0,0,1,66,93,A1,F6,H9
01_67_07,xcond_1,GRCm39,507,672,1107,506,671,1106,1,1,1,1,67,7,A1,F7,A7
01_67_09,xcond_1,GRCm39,366,457,758,365,456,756,1,1,2,1,67,9,A1,F7,A9
01_67_23,xcond_1,GRCm39,843,1378,2308,843,1378,2308,0,0,0,1,67,23,A1,F7,B11
01_67_29,xcond_1,GRCm39,733,1051,1660,731,1049,1658,2,2,2,1,67,29,A1,F7,C5
01_67_81,xcond_1,GRCm39,804,1265,2108,804,1265,2108,0,0,0,1,67,81,A1,F7,G9
01_68_09,xcond_1,GRCm39,1073,1604,2666,1073,1604,2666,0,0,0,1,68,9,A1,F8,A9
01_68_11,xcond_1,GRCm39,1117,2095,3414,1116,2094,3413,1,1,1,1,68,11,A1,F8,A11
01_68_57,xcond_1,GRCm39,307,359,587,307,359,587,0,0,0,1,68,57,A1,F8,E9
01_68_72,xcond_1,GRCm39,836,1621,2682,835,1619,2677,1,2,5,1,68,72,A1,F8,F12
01_68_91,xcond_1,GRCm39,1683,3092,5177,1680,3089,5174,3,3,3,1,68,91,A1,F8,H7
01_68_93,xcond_1,GRCm39,550,815,1391,548,813,1387,2,2,4,1,68,93,A1,F8,H9
01_69_12,xcond_1,GRCm39,2491,5986,9729,2486,5977,9714,5,9,15,1,69,12,A1,F9,A12
01_69_32,xcond_1,GRCm39,678,972,1621,677,971,1620,1,1,1,1,69,32,A1,F9,C8
01_69_41,xcond_1,GRCm39,160,229,312,160,229,312,0,0,0,1,69,41,A1,F9,D5
01_69_54,xcond_1,GRCm39,507,755,1266,505,753,1262,2,2,4,1,69,54,A1,F9,E6
01_69_73,xcond_1,GRCm39,529,740,1156,528,739,1154,1,1,2,1,69,73,A1,F9,G1
01_70_11,xcond_1,GRCm39,5056,17761,29600,5043,17737,29557,13,24,43,1,70,11,A1,F10,A11
01_70_53,xcond_1,GRCm39,305,384,661,304,383,658,1,1,3,1,70,53,A1,F10,E5
01_70_69,xcond_1,GRCm39,400,541,845,400,541,845,0,0,0,1,70,69,A1,F10,F9
01_70_90,xcond_1,GRCm39,1561,2536,4318,1561,2536,4318,0,0,0,1,70,90,A1,F10,H6
01_71_03,xcond_1,GRCm39,665,974,1590,664,973,1589,1,1,1,1,71,3,A1,F11,A3
01_71_21,xcond_1,GRCm39,329,450,683,329,450,683,0,0,0,1,71,21,A1,F11,B9
01_71_51,xcond_1,GRCm39,510,776,1287,510,776,1287,0,0,0,1,71,51,A1,F11,E3
01_71_59,xcond_1,GRCm39,511,748,1189,511,748,1189,0,0,0,1,71,59,A1,F11,E11
01_71_66,xcond_1,GRCm39,588,961,1550,587,960,1549,1,1,1,1,71,66,A1,F11,F6
01_71_68,xcond_1,GRCm39,854,1423,2301,853,1422,2300,1,1,1,1,71,68,A1,F11,F8
01_71_69,xcond_1,GRCm39,278,375,622,278,375,622,0,0,0,1,71,69,A1,F11,F9
01_72_18,xcond_1,GRCm39,884,1224,2056,883,1223,2055,1,1,1,1,72,18,A1,F12,B6
01_73_07,xcond_1,GRCm39,780,1128,1847,778,1124,1841,2,4,6,1,73,7,A1,G1,A7
01_73_11,xcond_1,GRCm39,2795,6318,10405,2792,6315,10402,3,3,3,1,73,11,A1,G1,A11
01_73_18,xcond_1,GRCm39,229,268,441,229,268,441,0,0,0,1,73,18,A1,G1,B6
01_73_31,xcond_1,GRCm39,553,814,1329,552,813,1328,1,1,1,1,73,31,A1,G1,C7
01_73_33,xcond_1,GRCm39,1984,3811,6250,1981,3808,6247,3,3,3,1,73,33,A1,G1,C9
01_73_83,xcond_1,GRCm39,335,410,643,334,409,642,1,1,1,1,73,83,A1,G1,G11
01_74_02,xcond_1,GRCm39,668,911,1483,667,910,1480,1,1,3,1,74,2,A1,G2,A2
01_74_08,xcond_1,GRCm39,1220,2394,3865,1217,2391,3862,3,3,3,1,74,8,A1,G2,A8
01_74_52,xcond_1,GRCm39,1406,2200,3522,1405,2198,3517,1,2,5,1,74,52,A1,G2,E4
01_74_62,xcond_1,GRCm39,838,1202,1952,836,1199,1947,2,3,5,1,74,62,A1,G2,F2
01_74_83,xcond_1,GRCm39,596,841,1379,595,840,1378,1,1,1,1,74,83,A1,G2,G11
01_74_90,xcond_1,GRCm39,384,586,962,383,585,961,1,1,1,1,74,90,A1,G2,H6
01_74_91,xcond_1,GRCm39,4663,17022,27945,4654,17006,27918,9,16,27,1,74,91,A1,G2,H7
01_75_07,xcond_1,GRCm39,1272,2156,3534,1270,2154,3532,2,2,2,1,75,7,A1,G3,A7
01_75_53,xcond_1,GRCm39,614,1109,1807,612,1107,1805,2,2,2,1,75,53,A1,G3,E5
01_75_71,xcond_1,GRCm39,1031,2048,3249,1030,2047,3248,1,1,1,1,75,71,A1,G3,F11
01_75_76,xcond_1,GRCm39,611,1016,1662,611,1016,1662,0,0,0,1,75,76,A1,G3,G4
01_76_25,xcond_1,GRCm39,1340,2332,3844,1340,2332,3844,0,0,0,1,76,25,A1,G4,C1
01_76_57,xcond_1,GRCm39,357,530,832,357,530,832,0,0,0,1,76,57,A1,G4,E9
01_76_62,xcond_1,GRCm39,379,517,864,377,515,862,2,2,2,1,76,62,A1,G4,F2
01_76_85,xcond_1,GRCm39,337,903,1498,337,903,1498,0,0,0,1,76,85,A1,G4,H1
01_76_96,xcond_1,GRCm39,532,704,1195,531,703,1192,1,1,3,1,76,96,A1,G4,H12
01_77_37,xcond_1,GRCm39,868,1558,2549,867,1557,2548,1,1,1,1,77,37,A1,G5,D1
01_77_40,xcond_1,GRCm39,256,296,477,256,296,477,0,0,0,1,77,40,A1,G5,D4
01_77_72,xcond_1,GRCm39,569,884,1500,568,883,1498,1,1,2,1,77,72,A1,G5,F12
01_77_80,xcond_1,GRCm39,1228,1940,3206,1226,1938,3204,2,2,2,1,77,80,A1,G5,G8
01_78_40,xcond_1,GRCm39,359,544,861,358,540,857,1,4,4,1,78,40,A1,G6,D4
01_78_60,xcond_1,GRCm39,742,1172,1934,741,1171,1932,1,1,2,1,78,60,A1,G6,E12
01_78_87,xcond_1,GRCm39,172,213,376,171,212,375,1,1,1,1,78,87,A1,G6,H3
01_79_11,xcond_1,GRCm39,820,1283,2098,818,1280,2094,2,3,4,1,79,11,A1,G7,A11
01_79_15,xcond_1,GRCm39,427,588,934,427,588,934,0,0,0,1,79,15,A1,G7,B3
01_79_20,xcond_1,GRCm39,241,346,545,240,345,544,1,1,1,1,79,20,A1,G7,B8
01_79_21,xcond_1,GRCm39,538,699,1176,537,698,1174,1,1,2,1,79,21,A1,G7,B9
01_79_23,xcond_1,GRCm39,1193,2427,4026,1193,2427,4026,0,0,0,1,79,23,A1,G7,B11
01_79_27,xcond_1,GRCm39,2171,4435,7271,2170,4434,7270,1,1,1,1,79,27,A1,G7,C3
01_79_40,xcond_1,GRCm39,435,653,1091,435,653,1091,0,0,0,1,79,40,A1,G7,D4
01_79_79,xcond_1,GRCm39,489,681,1176,489,681,1176,0,0,0,1,79,79,A1,G7,G7
01_80_60,xcond_1,GRCm39,210,248,396,210,248,396,0,0,0,1,80,60,A1,G8,E12
01_80_81,xcond_1,GRCm39,393,529,887,393,529,887,0,0,0,1,80,81,A1,G8,G9
01_80_84,xcond_1,GRCm39,694,966,1617,694,966,1617,0,0,0,1,80,84,A1,G8,G12
01_81_42,xcond_1,GRCm39,210,283,484,210,283,484,0,0,0,1,81,42,A1,G9,D6
01_81_60,xcond_1,GRCm39,234,273,459,234,273,459,0,0,0,1,81,60,A1,G9,E12
01_81_77,xcond_1,GRCm39,743,1411,2225,742,1410,2223,1,1,2,1,81,77,A1,G9,G5
01_81_86,xcond_1,GRCm39,417,620,1032,417,620,1032,0,0,0,1,81,86,A1,G9,H2
01_82_09,xcond_1,GRCm39,559,855,1346,559,855,1346,0,0,0,1,82,9,A1,G10,A9
01_82_28,xcond_1,GRCm39,557,778,1252,557,778,1252,0,0,0,1,82,28,A1,G10,C4
01_82_37,xcond_1,GRCm39,238,324,511,238,324,511,0,0,0,1,82,37,A1,G10,D1
01_82_38,xcond_1,GRCm39,581,805,1326,581,805,1326,0,0,0,1,82,38,A1,G10,D2
01_82_57,xcond_1,GRCm39,304,396,609,303,395,608,1,1,1,1,82,57,A1,G10,E9
01_82_71,xcond_1,GRCm39,3359,7800,12567,3355,7796,12563,4,4,4,1,82,71,A1,G10,F11
01_82_83,xcond_1,GRCm39,247,392,634,247,392,634,0,0,0,1,82,83,A1,G10,G11
01_83_01,xcond_1,GRCm39,156,317,520,156,317,520,0,0,0,1,83,1,A1,G11,A1
01_83_33,xcond_1,GRCm39,204,280,450,204,280,450,0,0,0,1,83,33,A1,G11,C9
01_83_96,xcond_1,GRCm39,333,534,865,331,532,862,2,2,3,1,83,96,A1,G11,H12
01_85_21,xcond_1,GRCm39,549,817,1314,549,817,1314,0,0,0,1,85,21,A1,H1,B9
01_85_57,xcond_1,GRCm39,434,642,1044,434,642,1044,0,0,0,1,85,57,A1,H1,E9
01_85_96,xcond_1,GRCm39,521,796,1282,521,796,1282,0,0,0,1,85,96,A1,H1,H12
01_86_37,xcond_1,GRCm39,322,385,602,321,384,601,1,1,1,1,86,37,A1,H2,D1
01_86_53,xcond_1,GRCm39,658,964,1613,657,962,1610,1,2,3,1,86,53,A1,H2,E5
01_86_57,xcond_1,GRCm39,227,310,519,227,310,519,0,0,0,1,86,57,A1,H2,E9
01_86_76,xcond_1,GRCm39,2336,4483,7230,2335,4480,7222,1,3,8,1,86,76,A1,H2,G4
01_86_88,xcond_1,GRCm39,283,395,659,283,395,659,0,0,0,1,86,88,A1,H2,H4
01_87_02,xcond_1,GRCm39,295,360,608,295,360,608,0,0,0,1,87,2,A1,H3,A2
01_87_03,xcond_1,GRCm39,1159,2206,3473,1157,2203,3469,2,3,4,1,87,3,A1,H3,A3
01_87_06,xcond_1,GRCm39,1068,2223,3510,1067,2220,3506,1,3,4,1,87,6,A1,H3,A6
01_87_11,xcond_1,GRCm39,530,796,1291,530,796,1291,0,0,0,1,87,11,A1,H3,A11
01_87_24,xcond_1,GRCm39,443,667,1073,443,667,1073,0,0,0,1,87,24,A1,H3,B12
01_87_38,xcond_1,GRCm39,270,424,722,270,424,722,0,0,0,1,87,38,A1,H3,D2
01_87_59,xcond_1,GRCm39,602,866,1343,600,864,1339,2,2,4,1,87,59,A1,H3,E11
01_87_81,xcond_1,GRCm39,656,1162,1840,653,1159,1837,3,3,3,1,87,81,A1,H3,G9
01_88_11,xcond_1,GRCm39,341,435,707,341,435,707,0,0,0,1,88,11,A1,H4,A11
01_88_12,xcond_1,GRCm39,326,409,655,326,409,655,0,0,0,1,88,12,A1,H4,A12
01_88_15,xcond_1,GRCm39,801,1265,2024,799,1262,2018,2,3,6,1,88,15,A1,H4,B3
01_88_20,xcond_1,GRCm39,576,971,1544,575,970,1543,1,1,1,1,88,20,A1,H4,B8
01_88_25,xcond_1,GRCm39,1978,4116,6595,1976,4114,6591,2,2,4,1,88,25,A1,H4,C1
01_88_38,xcond_1,GRCm39,808,1248,2072,807,1246,2069,1,2,3,1,88,38,A1,H4,D2
01_88_49,xcond_1,GRCm39,471,692,1072,471,692,1072,0,0,0,1,88,49,A1,H4,E1
01_88_62,xcond_1,GRCm39,1141,2085,3329,1140,2084,3328,1,1,1,1,88,62,A1,H4,F2
01_89_02,xcond_1,GRCm39,504,721,1197,504,721,1197,0,0,0,1,89,2,A1,H5,A2
01_89_15,xcond_1,GRCm39,811,1164,1962,809,1162,1958,2,2,4,1,89,15,A1,H5,B3
01_89_24,xcond_1,GRCm39,412,565,940,411,564,939,1,1,1,1,89,24,A1,H5,B12
01_89_31,xcond_1,GRCm39,1251,2041,3338,1249,2039,3331,2,2,7,1,89,31,A1,H5,C7
01_89_57,xcond_1,GRCm39,414,524,838,414,524,838,0,0,0,1,89,57,A1,H5,E9
01_89_69,xcond_1,GRCm39,226,354,623,226,354,623,0,0,0,1,89,69,A1,H5,F9
01_90_01,xcond_1,GRCm39,1650,4007,6648,1648,4005,6644,2,2,4,1,90,1,A1,H6,A1
01_90_23,xcond_1,GRCm39,653,998,1694,652,997,1693,1,1,1,1,90,23,A1,H6,B11
01_90_49,xcond_1,GRCm39,1264,2315,3896,1263,2314,3894,1,1,2,1,90,49,A1,H6,E1
01_90_79,xcond_1,GRCm39,514,721,1248,514,721,1248,0,0,0,1,90,79,A1,H6,G7
01_90_96,xcond_1,GRCm39,513,690,1194,513,690,1194,0,0,0,1,90,96,A1,H6,H12
01_91_24,xcond_1,GRCm39,915,1546,2476,915,1546,2476,0,0,0,1,91,24,A1,H7,B12
01_91_84,xcond_1,GRCm39,976,1611,2604,973,1608,2601,3,3,3,1,91,84,A1,H7,G12
01_91_86,xcond_1,GRCm39,1181,2529,4173,1179,2523,4165,2,6,8,1,91,86,A1,H7,H2
01_91_88,xcond_1,GRCm39,2415,5510,9096,2409,5498,9078,6,12,18,1,91,88,A1,H7,H4
01_92_09,xcond_1,GRCm39,889,1730,2839,887,1725,2833,2,5,6,1,92,9,A1,H8,A9
01_92_19,xcond_1,GRCm39,603,1026,1678,603,1026,1678,0,0,0,1,92,19,A1,H8,B7
01_92_20,xcond_1,GRCm39,857,1381,2205,856,1380,2203,1,1,2,1,92,20,A1,H8,B8
01_93_25,xcond_1,GRCm39,225,412,654,225,412,654,0,0,0,1,93,25,A1,H9,C1
01_93_38,xcond_1,GRCm39,1306,2126,3428,1304,2124,3426,2,2,2,1,93,38,A1,H9,D2
01_93_52,xcond_1,GRCm39,529,875,1391,529,875,1391,0,0,0,1,93,52,A1,H9,E4
01_93_62,xcond_1,GRCm39,678,927,1534,678,927,1534,0,0,0,1,93,62,A1,H9,F2
01_94_24,xcond_1,GRCm39,200,229,434,200,229,434,0,0,0,1,94,24,A1,H10,B12
01_94_55,xcond_1,GRCm39,560,771,1282,559,770,1276,1,1,6,1,94,55,A1,H10,E7
01_95_11,xcond_1,GRCm39,446,568,900,445,567,899,1,1,1,1,95,11,A1,H11,A11
01_95_32,xcond_1,GRCm39,710,979,1648,709,978,1647,1,1,1,1,95,32,A1,H11,C8
01_95_84,xcond_1,GRCm39,1085,1737,2959,1084,1736,2958,1,1,1,1,95,84,A1,H11,G12
01_96_18,xcond_1,GRCm39,226,294,499,226,294,499,0,0,0,1,96,18,A1,H12,B6
01_96_41,xcond_1,GRCm39,507,712,1188,507,712,1188,0,0,0,1,96,41,A1,H12,D5
02_01_08,xcond_1,GRCm39,613,803,1334,613,803,1334,0,0,0,2,1,8,A2,A1,A8
02_01_57,xcond_1,GRCm39,618,985,1633,617,984,1631,1,1,2,2,1,57,A2,A1,E9
02_01_77,xcond_1,GRCm39,460,639,995,459,638,992,1,1,3,2,1,77,A2,A1,G5
02_01_87,xcond_1,GRCm39,1082,1937,3104,1080,1935,3102,2,2,2,2,1,87,A2,A1,H3
02_01_96,xcond_1,GRCm39,689,1094,1782,688,1093,1781,1,1,1,2,1,96,A2,A1,H12
02_02_61,xcond_1,GRCm39,1818,3278,5337,1816,3275,5333,2,3,4,2,2,61,A2,A2,F1
02_03_20,xcond_1,GRCm39,833,1363,2269,833,1363,2269,0,0,0,2,3,20,A2,A3,B8
02_03_72,xcond_1,GRCm39,393,546,914,393,546,914,0,0,0,2,3,72,A2,A3,F12
02_03_96,xcond_1,GRCm39,384,473,810,381,470,806,3,3,4,2,3,96,A2,A3,H12
02_04_19,xcond_1,GRCm39,590,800,1315,590,800,1315,0,0,0,2,4,19,A2,A4,B7
02_04_21,xcond_1,GRCm39,312,625,977,311,624,976,1,1,1,2,4,21,A2,A4,B9
02_04_43,xcond_1,GRCm39,963,1454,2351,963,1454,2351,0,0,0,2,4,43,A2,A4,D7
02_05_08,xcond_1,GRCm39,775,1403,2261,774,1402,2260,1,1,1,2,5,8,A2,A5,A8
02_05_13,xcond_1,GRCm39,557,786,1273,556,785,1270,1,1,3,2,5,13,A2,A5,B1
02_05_49,xcond_1,GRCm39,1151,1974,3180,1150,1973,3178,1,1,2,2,5,49,A2,A5,E1
02_05_74,xcond_1,GRCm39,626,992,1593,625,990,1588,1,2,5,2,5,74,A2,A5,G2
02_05_93,xcond_1,GRCm39,854,1393,2282,853,1392,2279,1,1,3,2,5,93,A2,A5,H9
02_06_05,xcond_1,GRCm39,567,853,1436,567,853,1436,0,0,0,2,6,5,A2,A6,A5
02_06_18,xcond_1,GRCm39,721,1132,1944,721,1132,1944,0,0,0,2,6,18,A2,A6,B6
02_06_19,xcond_1,GRCm39,559,825,1335,559,825,1335,0,0,0,2,6,19,A2,A6,B7
02_06_29,xcond_1,GRCm39,1160,1800,2892,1159,1798,2888,1,2,4,2,6,29,A2,A6,C5
02_07_18,xcond_1,GRCm39,1001,1516,2472,1000,1515,2470,1,1,2,2,7,18,A2,A7,B6
02_07_45,xcond_1,GRCm39,249,314,531,249,314,531,0,0,0,2,7,45,A2,A7,D9
02_07_85,xcond_1,GRCm39,1268,2110,3550,1267,2109,3549,1,1,1,2,7,85,A2,A7,H1
02_08_19,xcond_1,GRCm39,784,1181,1847,782,1179,1844,2,2,3,2,8,19,A2,A8,B7
02_08_57,xcond_1,GRCm39,401,549,883,401,549,883,0,0,0,2,8,57,A2,A8,E9
02_08_60,xcond_1,GRCm39,410,579,939,409,578,938,1,1,1,2,8,60,A2,A8,E12
02_08_93,xcond_1,GRCm39,783,1108,1772,782,1106,1767,1,2,5,2,8,93,A2,A8,H9
02_09_09,xcond_1,GRCm39,341,434,702,339,432,700,2,2,2,2,9,9,A2,A9,A9
02_09_32,xcond_1,GRCm39,586,874,1423,585,873,1422,1,1,1,2,9,32,A2,A9,C8
02_09_52,xcond_1,GRCm39,637,965,1553,636,964,1551,1,1,2,2,9,52,A2,A9,E4
02_09_87,xcond_1,GRCm39,454,638,1062,454,638,1062,0,0,0,2,9,87,A2,A9,H3
02_10_12,xcond_1,GRCm39,442,655,1072,441,654,1069,1,1,3,2,10,12,A2,A10,A12
02_10_33,xcond_1,GRCm39,346,478,780,346,478,780,0,0,0,2,10,33,A2,A10,C9
02_10_81,xcond_1,GRCm39,232,271,447,232,271,447,0,0,0,2,10,81,A2,A10,G9
02_11_56,xcond_1,GRCm39,2409,5117,8038,2407,5112,8029,2,5,9,2,11,56,A2,A11,E8
02_11_69,xcond_1,GRCm39,1161,1950,2932,1161,1950,2932,0,0,0,2,11,69,A2,A11,F9
02_12_66,xcond_1,GRCm39,283,434,717,281,430,712,2,4,5,2,12,66,A2,A12,F6
02_12_68,xcond_1,GRCm39,629,947,1529,629,947,1529,0,0,0,2,12,68,A2,A12,F8
02_12_85,xcond_1,GRCm39,578,806,1315,577,805,1314,1,1,1,2,12,85,A2,A12,H1
02_13_43,xcond_1,GRCm39,480,622,990,480,622,990,0,0,0,2,13,43,A2,B1,D7
02_13_75,xcond_1,GRCm39,813,1710,2731,811,1708,2728,2,2,3,2,13,75,A2,B1,G3
02_14_09,xcond_1,GRCm39,321,388,659,321,388,659,0,0,0,2,14,9,A2,B2,A9
02_14_33,xcond_1,GRCm39,569,790,1227,569,790,1227,0,0,0,2,14,33,A2,B2,C9
02_14_60,xcond_1,GRCm39,726,1176,1968,726,1176,1968,0,0,0,2,14,60,A2,B2,E12
02_14_89,xcond_1,GRCm39,535,692,1107,535,692,1107,0,0,0,2,14,89,A2,B2,H5
02_15_04,xcond_1,GRCm39,867,1340,2183,865,1338,2181,2,2,2,2,15,4,A2,B3,A4
02_15_06,xcond_1,GRCm39,926,1489,2386,925,1488,2383,1,1,3,2,15,6,A2,B3,A6
02_15_53,xcond_1,GRCm39,451,596,994,450,595,991,1,1,3,2,15,53,A2,B3,E5
02_15_63,xcond_1,GRCm39,277,366,590,277,366,590,0,0,0,2,15,63,A2,B3,F3
02_15_72,xcond_1,GRCm39,517,718,1156,516,717,1155,1,1,1,2,15,72,A2,B3,F12
02_15_83,xcond_1,GRCm39,930,1695,2721,928,1692,2718,2,3,3,2,15,83,A2,B3,G11
02_16_64,xcond_1,GRCm39,249,303,458,248,302,456,1,1,2,2,16,64,A2,B4,F4
02_17_23,xcond_1,GRCm39,408,541,870,408,541,870,0,0,0,2,17,23,A2,B5,B11
02_17_36,xcond_1,GRCm39,673,1051,1744,672,1050,1741,1,1,3,2,17,36,A2,B5,C12
02_17_64,xcond_1,GRCm39,1077,1599,2570,1076,1598,2568,1,1,2,2,17,64,A2,B5,F4
02_18_36,xcond_1,GRCm39,2643,5655,9150,2640,5651,9145,3,4,5,2,18,36,A2,B6,C12
02_18_44,xcond_1,GRCm39,566,879,1385,565,878,1384,1,1,1,2,18,44,A2,B6,D8
02_18_50,xcond_1,GRCm39,544,736,1193,544,736,1193,0,0,0,2,18,50,A2,B6,E2
02_18_52,xcond_1,GRCm39,700,1004,1559,698,1002,1556,2,2,3,2,18,52,A2,B6,E4
02_18_78,xcond_1,GRCm39,1520,2761,4474,1519,2760,4473,1,1,1,2,18,78,A2,B6,G6
02_18_84,xcond_1,GRCm39,262,423,655,261,422,654,1,1,1,2,18,84,A2,B6,G12
02_19_11,xcond_1,GRCm39,895,1499,2445,895,1499,2445,0,0,0,2,19,11,A2,B7,A11
02_19_56,xcond_1,GRCm39,2266,4848,7864,2263,4844,7859,3,4,5,2,19,56,A2,B7,E8
02_20_02,xcond_1,GRCm39,226,286,449,226,286,449,0,0,0,2,20,2,A2,B8,A2
02_20_33,xcond_1,GRCm39,1689,3002,4863,1688,3001,4862,1,1,1,2,20,33,A2,B8,C9
02_20_83,xcond_1,GRCm39,723,1046,1700,722,1044,1697,1,2,3,2,20,83,A2,B8,G11
02_20_92,xcond_1,GRCm39,62,297,469,61,296,467,1,1,2,2,20,92,A2,B8,H8
02_21_73,xcond_1,GRCm39,805,1168,1962,803,1166,1959,2,2,3,2,21,73,A2,B9,G1
02_21_91,xcond_1,GRCm39,551,1039,1692,551,1039,1692,0,0,0,2,21,91,A2,B9,H7
02_21_96,xcond_1,GRCm39,460,578,973,460,578,973,0,0,0,2,21,96,A2,B9,H12
02_22_24,xcond_1,GRCm39,531,768,1218,529,765,1213,2,3,5,2,22,24,A2,B10,B12
02_22_95,xcond_1,GRCm39,510,705,1155,507,702,1150,3,3,5,2,22,95,A2,B10,H11
02_23_21,xcond_1,GRCm39,821,1304,2080,821,1304,2080,0,0,0,2,23,21,A2,B11,B9
02_23_24,xcond_1,GRCm39,659,963,1562,658,962,1561,1,1,1,2,23,24,A2,B11,B12
02_23_62,xcond_1,GRCm39,697,1121,1854,696,1120,1853,1,1,1,2,23,62,A2,B11,F2
02_23_74,xcond_1,GRCm39,604,951,1494,603,950,1493,1,1,1,2,23,74,A2,B11,G2
02_24_31,xcond_1,GRCm39,1043,1627,2791,1042,1626,2789,1,1,2,2,24,31,A2,B12,C7
02_24_45,xcond_1,GRCm39,1169,1896,3107,1168,1895,3106,1,1,1,2,24,45,A2,B12,D9
02_24_93,xcond_1,GRCm39,556,745,1294,556,745,1294,0,0,0,2,24,93,A2,B12,H9
02_24_95,xcond_1,GRCm39,944,1421,2372,944,1421,2372,0,0,0,2,24,95,A2,B12,H11
02_25_25,xcond_1,GRCm39,401,588,953,400,587,952,1,1,1,2,25,25,A2,C1,C1
02_25_33,xcond_1,GRCm39,83,224,358,83,224,358,0,0,0,2,25,33,A2,C1,C9
02_25_43,xcond_1,GRCm39,912,1530,2458,912,1530,2458,0,0,0,2,25,43,A2,C1,D7
02_25_67,xcond_1,GRCm39,830,1405,2301,829,1404,2300,1,1,1,2,25,67,A2,C1,F7
02_25_72,xcond_1,GRCm39,517,683,1144,514,680,1140,3,3,4,2,25,72,A2,C1,F12
02_26_33,xcond_1,GRCm39,264,314,493,264,314,493,0,0,0,2,26,33,A2,C2,C9
02_27_09,xcond_1,GRCm39,237,314,477,237,314,477,0,0,0,2,27,9,A2,C3,A9
02_27_61,xcond_1,GRCm39,512,790,1229,510,788,1227,2,2,2,2,27,61,A2,C3,F1
02_27_84,xcond_1,GRCm39,2857,7093,11636,2852,7087,11627,5,6,9,2,27,84,A2,C3,G12
02_28_11,xcond_1,GRCm39,711,989,1571,710,988,1570,1,1,1,2,28,11,A2,C4,A11
02_28_28,xcond_1,GRCm39,539,854,1377,538,853,1375,1,1,2,2,28,28,A2,C4,C4
02_28_36,xcond_1,GRCm39,883,1531,2529,881,1528,2524,2,3,5,2,28,36,A2,C4,C12
02_28_39,xcond_1,GRCm39,792,1314,2121,792,1314,2121,0,0,0,2,28,39,A2,C4,D3
02_28_59,xcond_1,GRCm39,2437,4778,7603,2435,4774,7598,2,4,5,2,28,59,A2,C4,E11
02_28_75,xcond_1,GRCm39,585,869,1478,585,869,1478,0,0,0,2,28,75,A2,C4,G3
02_28_78,xcond_1,GRCm39,1358,2261,3739,1356,2258,3733,2,3,6,2,28,78,A2,C4,G6
02_29_18,xcond_1,GRCm39,655,894,1486,655,894,1486,0,0,0,2,29,18,A2,C5,B6
02_29_30,xcond_1,GRCm39,256,329,547,255,328,545,1,1,2,2,29,30,A2,C5,C6
02_29_43,xcond_1,GRCm39,567,860,1417,566,859,1416,1,1,1,2,29,43,A2,C5,D7
02_29_74,xcond_1,GRCm39,535,756,1247,535,756,1247,0,0,0,2,29,74,A2,C5,G2
02_29_81,xcond_1,GRCm39,614,867,1392,613,866,1391,1,1,1,2,29,81,A2,C5,G9
02_29_85,xcond_1,GRCm39,677,1037,1694,676,1036,1692,1,1,2,2,29,85,A2,C5,H1
02_29_86,xcond_1,GRCm39,580,848,1364,578,846,1359,2,2,5,2,29,86,A2,C5,H2
02_30_23,xcond_1,GRCm39,487,801,1286,484,798,1283,3,3,3,2,30,23,A2,C6,B11
02_31_01,xcond_1,GRCm39,2894,6741,11149,2892,6734,11135,2,7,14,2,31,1,A2,C7,A1
02_31_12,xcond_1,GRCm39,2110,4236,6914,2107,4232,6904,3,4,10,2,31,12,A2,C7,A12
02_31_15,xcond_1,GRCm39,1038,1807,2978,1035,1804,2974,3,3,4,2,31,15,A2,C7,B3
02_31_45,xcond_1,GRCm39,635,925,1525,635,925,1525,0,0,0,2,31,45,A2,C7,D9
02_32_11,xcond_1,GRCm39,521,699,1163,521,699,1163,0,0,0,2,32,11,A2,C8,A11
02_32_20,xcond_1,GRCm39,843,1237,1994,843,1237,1994,0,0,0,2,32,20,A2,C8,B8
02_32_62,xcond_1,GRCm39,896,1404,2369,896,1404,2369,0,0,0,2,32,62,A2,C8,F2
02_32_64,xcond_1,GRCm39,844,1467,2338,842,1464,2335,2,3,3,2,32,64,A2,C8,F4
02_32_84,xcond_1,GRCm39,306,373,578,305,372,576,1,1,2,2,32,84,A2,C8,G12
02_33_41,xcond_1,GRCm39,888,1762,2832,888,1762,2832,0,0,0,2,33,41,A2,C9,D5
02_33_57,xcond_1,GRCm39,397,577,940,397,577,940,0,0,0,2,33,57,A2,C9,E9
02_33_77,xcond_1,GRCm39,464,603,978,464,603,978,0,0,0,2,33,77,A2,C9,G5
02_33_78,xcond_1,GRCm39,398,544,863,397,543,860,1,1,3,2,33,78,A2,C9,G6
02_34_24,xcond_1,GRCm39,1174,2696,4434,1174,2696,4434,0,0,0,2,34,24,A2,C10,B12
02_34_93,xcond_1,GRCm39,584,925,1540,583,924,1535,1,1,5,2,34,93,A2,C10,H9
02_35_19,xcond_1,GRCm39,1812,4098,6465,1809,4093,6458,3,5,7,2,35,19,A2,C11,B7
02_35_72,xcond_1,GRCm39,708,991,1665,707,990,1664,1,1,1,2,35,72,A2,C11,F12
02_36_01,xcond_1,GRCm39,614,908,1465,613,907,1464,1,1,1,2,36,1,A2,C12,A1
02_36_11,xcond_1,GRCm39,303,483,776,303,483,776,0,0,0,2,36,11,A2,C12,A11
02_36_18,xcond_1,GRCm39,937,1426,2278,937,1426,2278,0,0,0,2,36,18,A2,C12,B6
02_36_40,xcond_1,GRCm39,704,1051,1716,704,1051,1716,0,0,0,2,36,40,A2,C12,D4
02_36_45,xcond_1,GRCm39,296,352,608,296,352,608,0,0,0,2,36,45,A2,C12,D9
02_36_49,xcond_1,GRCm39,1140,1772,2867,1139,1771,2865,1,1,2,2,36,49,A2,C12,E1
02_36_52,xcond_1,GRCm39,453,599,889,451,597,886,2,2,3,2,36,52,A2,C12,E4
02_36_57,xcond_1,GRCm39,289,342,532,289,342,532,0,0,0,2,36,57,A2,C12,E9
02_36_86,xcond_1,GRCm39,723,1084,1756,722,1083,1755,1,1,1,2,36,86,A2,C12,H2
02_37_01,xcond_1,GRCm39,383,567,951,383,567,951,0,0,0,2,37,1,A2,D1,A1
02_37_04,xcond_1,GRCm39,191,419,705,191,419,705,0,0,0,2,37,4,A2,D1,A4
02_37_16,xcond_1,GRCm39,687,1231,2099,686,1230,2098,1,1,1,2,37,16,A2,D1,B4
02_37_68,xcond_1,GRCm39,545,760,1277,543,758,1273,2,2,4,2,37,68,A2,D1,F8
02_38_02,xcond_1,GRCm39,594,924,1479,594,924,1479,0,0,0,2,38,2,A2,D2,A2
02_38_05,xcond_1,GRCm39,1525,2511,4193,1524,2510,4192,1,1,1,2,38,5,A2,D2,A5
02_38_09,xcond_1,GRCm39,546,865,1380,545,864,1379,1,1,1,2,38,9,A2,D2,A9
02_38_25,xcond_1,GRCm39,733,1069,1716,733,1069,1716,0,0,0,2,38,25,A2,D2,C1
02_38_33,xcond_1,GRCm39,1101,1733,2908,1098,1729,2901,3,4,7,2,38,33,A2,D2,C9
02_38_36,xcond_1,GRCm39,406,827,1342,405,826,1341,1,1,1,2,38,36,A2,D2,C12
02_38_41,xcond_1,GRCm39,892,1532,2427,890,1530,2425,2,2,2,2,38,41,A2,D2,D5
02_38_71,xcond_1,GRCm39,536,838,1342,536,838,1342,0,0,0,2,38,71,A2,D2,F11
02_38_84,xcond_1,GRCm39,450,580,961,450,580,961,0,0,0,2,38,84,A2,D2,G12
02_38_87,xcond_1,GRCm39,1376,2774,4575,1375,2773,4573,1,1,2,2,38,87,A2,D2,H3
02_39_08,xcond_1,GRCm39,1290,2005,3205,1289,2004,3204,1,1,1,2,39,8,A2,D3,A8
02_39_19,xcond_1,GRCm39,1781,3283,5238,1778,3276,5229,3,7,9,2,39,19,A2,D3,B7
02_39_32,xcond_1,GRCm39,457,624,1018,457,624,1018,0,0,0,2,39,32,A2,D3,C8
02_39_50,xcond_1,GRCm39,944,1450,2407,943,1449,2406,1,1,1,2,39,50,A2,D3,E2
02_39_52,xcond_1,GRCm39,390,518,809,390,518,809,0,0,0,2,39,52,A2,D3,E4
02_39_66,xcond_1,GRCm39,691,1049,1707,688,1045,1702,3,4,5,2,39,66,A2,D3,F6
02_39_81,xcond_1,GRCm39,176,333,505,176,333,505,0,0,0,2,39,81,A2,D3,G9
02_39_96,xcond_1,GRCm39,1113,2051,3278,1112,2050,3277,1,1,1,2,39,96,A2,D3,H12
02_41_56,xcond_1,GRCm39,919,1434,2385,919,1434,2385,0,0,0,2,41,56,A2,D5,E8
02_41_63,xcond_1,GRCm39,419,585,964,419,585,964,0,0,0,2,41,63,A2,D5,F3
02_41_81,xcond_1,GRCm39,806,1146,1923,806,1146,1923,0,0,0,2,41,81,A2,D5,G9
02_42_01,xcond_1,GRCm39,47,220,351,47,220,351,0,0,0,2,42,1,A2,D6,A1
02_42_54,xcond_1,GRCm39,3363,7946,13167,3356,7934,13154,7,12,13,2,42,54,A2,D6,E6
02_42_55,xcond_1,GRCm39,221,411,679,221,411,679,0,0,0,2,42,55,A2,D6,E7
02_42_57,xcond_1,GRCm39,237,285,443,236,284,440,1,1,3,2,42,57,A2,D6,E9
02_42_69,xcond_1,GRCm39,562,868,1400,561,867,1398,1,1,2,2,42,69,A2,D6,F9
02_43_30,xcond_1,GRCm39,989,1507,2499,989,1507,2499,0,0,0,2,43,30,A2,D7,C6
02_43_60,xcond_1,GRCm39,345,421,678,343,419,676,2,2,2,2,43,60,A2,D7,E12
02_43_72,xcond_1,GRCm39,350,459,770,350,459,770,0,0,0,2,43,72,A2,D7,F12
02_43_78,xcond_1,GRCm39,750,1266,2015,749,1265,2014,1,1,1,2,43,78,A2,D7,G6
02_43_96,xcond_1,GRCm39,988,1690,2701,988,1690,2701,0,0,0,2,43,96,A2,D7,H12
02_45_19,xcond_1,GRCm39,747,1078,1773,747,1078,1773,0,0,0,2,45,19,A2,D9,B7
02_45_57,xcond_1,GRCm39,632,939,1551,632,939,1551,0,0,0,2,45,57,A2,D9,E9
02_45_69,xcond_1,GRCm39,446,673,1141,446,673,1141,0,0,0,2,45,69,A2,D9,F9
02_46_47,xcond_1,GRCm39,891,1668,2728,888,1664,2717,3,4,11,2,46,47,A2,D10,D11
02_46_83,xcond_1,GRCm39,560,733,1205,559,732,1202,1,1,3,2,46,83,A2,D10,G11
02_47_02,xcond_1,GRCm39,577,776,1255,576,775,1254,1,1,1,2,47,2,A2,D11,A2
02_47_09,xcond_1,GRCm39,235,307,497,235,307,497,0,0,0,2,47,9,A2,D11,A9
02_47_43,xcond_1,GRCm39,523,802,1317,523,802,1317,0,0,0,2,47,43,A2,D11,D7
02_47_57,xcond_1,GRCm39,319,428,716,319,428,716,0,0,0,2,47,57,A2,D11,E9
02_48_09,xcond_1,GRCm39,210,299,480,210,299,480,0,0,0,2,48,9,A2,D12,A9
02_48_29,xcond_1,GRCm39,590,840,1337,590,840,1337,0,0,0,2,48,29,A2,D12,C5
02_48_48,xcond_1,GRCm39,395,548,870,395,548,870,0,0,0,2,48,48,A2,D12,D12
02_48_51,xcond_1,GRCm39,834,1367,2287,833,1366,2286,1,1,1,2,48,51,A2,D12,E3
02_48_83,xcond_1,GRCm39,479,636,1019,479,636,1019,0,0,0,2,48,83,A2,D12,G11
02_49_66,xcond_1,GRCm39,655,984,1636,655,984,1636,0,0,0,2,49,66,A2,E1,F6
02_49_78,xcond_1,GRCm39,439,652,1032,438,651,1031,1,1,1,2,49,78,A2,E1,G6
02_50_21,xcond_1,GRCm39,261,324,511,261,324,511,0,0,0,2,50,21,A2,E2,B9
02_50_44,xcond_1,GRCm39,518,693,1081,517,692,1080,1,1,1,2,50,44,A2,E2,D8
02_50_64,xcond_1,GRCm39,559,823,1342,559,823,1342,0,0,0,2,50,64,A2,E2,F4
02_50_72,xcond_1,GRCm39,492,797,1311,491,796,1307,1,1,4,2,50,72,A2,E2,F12
02_50_86,xcond_1,GRCm39,1133,1853,2949,1132,1852,2947,1,1,2,2,50,86,A2,E2,H2
02_50_90,xcond_1,GRCm39,535,780,1279,534,779,1277,1,1,2,2,50,90,A2,E2,H6
02_51_52,xcond_1,GRCm39,566,830,1351,566,830,1351,0,0,0,2,51,52,A2,E3,E4
02_51_56,xcond_1,GRCm39,557,777,1325,555,775,1323,2,2,2,2,51,56,A2,E3,E8
02_51_59,xcond_1,GRCm39,601,927,1531,601,927,1531,0,0,0,2,51,59,A2,E3,E11
02_51_61,xcond_1,GRCm39,319,409,646,319,409,646,0,0,0,2,51,61,A2,E3,F1
02_51_90,xcond_1,GRCm39,810,1302,2154,809,1301,2152,1,1,2,2,51,90,A2,E3,H6
02_51_96,xcond_1,GRCm39,483,636,1096,482,635,1095,1,1,1,2,51,96,A2,E3,H12
02_52_21,xcond_1,GRCm39,400,648,997,400,648,997,0,0,0,2,52,21,A2,E4,B9
02_53_36,xcond_1,GRCm39,2264,4462,7154,2261,4456,7144,3,6,10,2,53,36,A2,E5,C12
02_53_45,xcond_1,GRCm39,357,466,737,357,466,737,0,0,0,2,53,45,A2,E5,D9
02_53_78,xcond_1,GRCm39,441,716,1137,439,714,1135,2,2,2,2,53,78,A2,E5,G6
02_54_87,xcond_1,GRCm39,605,939,1567,604,938,1565,1,1,2,2,54,87,A2,E6,H3
02_54_90,xcond_1,GRCm39,523,763,1303,522,762,1302,1,1,1,2,54,90,A2,E6,H6
02_55_14,xcond_1,GRCm39,185,224,359,185,224,359,0,0,0,2,55,14,A2,E7,B2
02_55_28,xcond_1,GRCm39,392,557,909,390,555,907,2,2,2,2,55,28,A2,E7,C4
02_55_36,xcond_1,GRCm39,395,546,895,395,546,895,0,0,0,2,55,36,A2,E7,C12
02_55_38,xcond_1,GRCm39,417,701,1115,416,700,1114,1,1,1,2,55,38,A2,E7,D2
02_55_91,xcond_1,GRCm39,378,529,869,378,529,869,0,0,0,2,55,91,A2,E7,H7
02_56_24,xcond_1,GRCm39,556,800,1289,554,797,1282,2,3,7,2,56,24,A2,E8,B12
02_56_49,xcond_1,GRCm39,731,1003,1624,730,1002,1623,1,1,1,2,56,49,A2,E8,E1
02_56_50,xcond_1,GRCm39,660,960,1667,659,959,1666,1,1,1,2,56,50,A2,E8,E2
02_56_62,xcond_1,GRCm39,747,1145,1879,747,1145,1879,0,0,0,2,56,62,A2,E8,F2
02_56_87,xcond_1,GRCm39,996,2248,3579,995,2247,3578,1,1,1,2,56,87,A2,E8,H3
02_57_36,xcond_1,GRCm39,1242,2465,3981,1242,2465,3981,0,0,0,2,57,36,A2,E9,C12
02_58_05,xcond_1,GRCm39,1590,2602,4225,1588,2600,4223,2,2,2,2,58,5,A2,E10,A5
02_58_19,xcond_1,GRCm39,529,811,1288,529,811,1288,0,0,0,2,58,19,A2,E10,B7
02_58_45,xcond_1,GRCm39,291,424,654,290,423,653,1,1,1,2,58,45,A2,E10,D9
02_58_61,xcond_1,GRCm39,899,1419,2361,899,1419,2361,0,0,0,2,58,61,A2,E10,F1
02_58_95,xcond_1,GRCm39,702,963,1596,701,962,1595,1,1,1,2,58,95,A2,E10,H11
02_59_36,xcond_1,GRCm39,671,1025,1686,671,1025,1686,0,0,0,2,59,36,A2,E11,C12
02_59_72,xcond_1,GRCm39,452,771,1267,451,770,1262,1,1,5,2,59,72,A2,E11,F12
02_59_81,xcond_1,GRCm39,258,312,446,258,312,446,0,0,0,2,59,81,A2,E11,G9
02_59_84,xcond_1,GRCm39,577,833,1426,576,830,1420,1,3,6,2,59,84,A2,E11,G12
02_60_04,xcond_1,GRCm39,584,966,1624,583,965,1623,1,1,1,2,60,4,A2,E12,A4
02_60_16,xcond_1,GRCm39,897,1445,2292,897,1445,2292,0,0,0,2,60,16,A2,E12,B4
02_60_32,xcond_1,GRCm39,449,608,1031,448,607,1030,1,1,1,2,60,32,A2,E12,C8
02_60_40,xcond_1,GRCm39,963,1765,2959,963,1765,2959,0,0,0,2,60,40,A2,E12,D4
02_60_59,xcond_1,GRCm39,1136,1999,3265,1136,1999,3265,0,0,0,2,60,59,A2,E12,E11
02_61_55,xcond_1,GRCm39,921,1512,2403,920,1511,2398,1,1,5,2,61,55,A2,F1,E7
02_61_57,xcond_1,GRCm39,238,298,498,238,298,498,0,0,0,2,61,57,A2,F1,E9
02_62_21,xcond_1,GRCm39,506,721,1164,506,721,1164,0,0,0,2,62,21,A2,F2,B9
02_62_55,xcond_1,GRCm39,93,211,339,93,211,339,0,0,0,2,62,55,A2,F2,E7
02_62_61,xcond_1,GRCm39,975,1496,2534,973,1494,2532,2,2,2,2,62,61,A2,F2,F1
02_62_62,xcond_1,GRCm39,819,1307,2159,819,1307,2159,0,0,0,2,62,62,A2,F2,F2
02_62_85,xcond_1,GRCm39,692,1161,1894,690,1159,1892,2,2,2,2,62,85,A2,F2,H1
02_63_31,xcond_1,GRCm39,650,948,1540,650,948,1540,0,0,0,2,63,31,A2,F3,C7
02_63_35,xcond_1,GRCm39,208,252,384,208,252,384,0,0,0,2,63,35,A2,F3,C11
02_63_39,xcond_1,GRCm39,978,1592,2641,977,1590,2638,1,2,3,2,63,39,A2,F3,D3
02_63_49,xcond_1,GRCm39,794,1341,2155,794,1341,2155,0,0,0,2,63,49,A2,F3,E1
02_63_71,xcond_1,GRCm39,741,1124,1800,741,1124,1800,0,0,0,2,63,71,A2,F3,F11
02_63_73,xcond_1,GRCm39,1262,2499,4045,1260,2496,4040,2,3,5,2,63,73,A2,F3,G1
02_63_89,xcond_1,GRCm39,1405,2417,3900,1404,2416,3898,1,1,2,2,63,89,A2,F3,H5
02_64_09,xcond_1,GRCm39,482,697,1149,481,696,1148,1,1,1,2,64,9,A2,F4,A9
02_65_21,xcond_1,GRCm39,1419,2658,4367,1416,2655,4364,3,3,3,2,65,21,A2,F5,B9
02_65_24,xcond_1,GRCm39,571,841,1385,570,840,1384,1,1,1,2,65,24,A2,F5,B12
02_65_27,xcond_1,GRCm39,667,911,1544,667,911,1544,0,0,0,2,65,27,A2,F5,C3
02_65_75,xcond_1,GRCm39,719,1062,1817,718,1061,1814,1,1,3,2,65,75,A2,F5,G3
02_65_96,xcond_1,GRCm39,322,488,790,322,488,790,0,0,0,2,65,96,A2,F5,H12
02_66_06,xcond_1,GRCm39,588,1029,1679,587,1027,1676,1,2,3,2,66,6,A2,F6,A6
02_66_32,xcond_1,GRCm39,553,823,1363,553,823,1363,0,0,0,2,66,32,A2,F6,C8
02_66_76,xcond_1,GRCm39,561,970,1652,560,969,1651,1,1,1,2,66,76,A2,F6,G4
02_67_03,xcond_1,GRCm39,717,1125,1895,715,1123,1893,2,2,2,2,67,3,A2,F7,A3
02_67_61,xcond_1,GRCm39,1717,3254,5350,1715,3251,5347,2,3,3,2,67,61,A2,F7,F1
02_67_83,xcond_1,GRCm39,957,1440,2352,955,1438,2349,2,2,3,2,67,83,A2,F7,G11
02_67_87,xcond_1,GRCm39,813,1411,2342,808,1403,2333,5,8,9,2,67,87,A2,F7,H3
02_67_93,xcond_1,GRCm39,389,543,915,388,542,914,1,1,1,2,67,93,A2,F7,H9
02_68_02,xcond_1,GRCm39,385,689,1123,384,688,1121,1,1,2,2,68,2,A2,F8,A2
02_68_08,xcond_1,GRCm39,748,1169,1950,746,1167,1948,2,2,2,2,68,8,A2,F8,A8
02_68_09,xcond_1,GRCm39,415,573,939,415,573,939,0,0,0,2,68,9,A2,F8,A9
02_68_13,xcond_1,GRCm39,689,957,1592,689,957,1592,0,0,0,2,68,13,A2,F8,B1
02_68_16,xcond_1,GRCm39,356,442,698,356,442,698,0,0,0,2,68,16,A2,F8,B4
02_68_42,xcond_1,GRCm39,2330,4483,7262,2328,4479,7256,2,4,6,2,68,42,A2,F8,D6
02_68_45,xcond_1,GRCm39,418,532,852,417,531,851,1,1,1,2,68,45,A2,F8,D9
02_68_55,xcond_1,GRCm39,702,1021,1709,702,1021,1709,0,0,0,2,68,55,A2,F8,E7
02_68_74,xcond_1,GRCm39,848,1473,2448,846,1471,2446,2,2,2,2,68,74,A2,F8,G2
02_68_96,xcond_1,GRCm39,700,1172,1900,699,1171,1898,1,1,2,2,68,96,A2,F8,H12
02_69_25,xcond_1,GRCm39,1060,1694,2727,1059,1693,2726,1,1,1,2,69,25,A2,F9,C1
02_69_28,xcond_1,GRCm39,931,1540,2470,930,1538,2467,1,2,3,2,69,28,A2,F9,C4
02_69_41,xcond_1,GRCm39,246,295,408,246,295,408,0,0,0,2,69,41,A2,F9,D5
02_69_42,xcond_1,GRCm39,670,1001,1587,669,1000,1585,1,1,2,2,69,42,A2,F9,D6
02_69_55,xcond_1,GRCm39,1038,1852,2973,1037,1851,2972,1,1,1,2,69,55,A2,F9,E7
02_69_81,xcond_1,GRCm39,438,657,1052,437,656,1051,1,1,1,2,69,81,A2,F9,G9
02_69_87,xcond_1,GRCm39,1951,3738,6096,1948,3735,6092,3,3,4,2,69,87,A2,F9,H3
02_69_96,xcond_1,GRCm39,1773,3665,6036,1772,3664,6035,1,1,1,2,69,96,A2,F9,H12
02_70_25,xcond_1,GRCm39,554,744,1207,554,744,1207,0,0,0,2,70,25,A2,F10,C1
02_70_88,xcond_1,GRCm39,640,942,1611,637,939,1605,3,3,6,2,70,88,A2,F10,H4
02_73_12,xcond_1,GRCm39,1084,1993,3296,1082,1991,3292,2,2,4,2,73,12,A2,G1,A12
02_73_15,xcond_1,GRCm39,538,795,1288,538,795,1288,0,0,0,2,73,15,A2,G1,B3
02_73_45,xcond_1,GRCm39,336,403,664,335,402,662,1,1,2,2,73,45,A2,G1,D9
02_74_04,xcond_1,GRCm39,947,1385,2296,947,1385,2296,0,0,0,2,74,4,A2,G2,A4
02_74_08,xcond_1,GRCm39,665,941,1486,663,939,1483,2,2,3,2,74,8,A2,G2,A8
02_74_11,xcond_1,GRCm39,466,716,1162,465,715,1160,1,1,2,2,74,11,A2,G2,A11
02_74_50,xcond_1,GRCm39,1087,1548,2550,1086,1547,2547,1,1,3,2,74,50,A2,G2,E2
02_74_71,xcond_1,GRCm39,549,828,1318,547,826,1314,2,2,4,2,74,71,A2,G2,F11
02_74_81,xcond_1,GRCm39,447,580,932,447,580,932,0,0,0,2,74,81,A2,G2,G9
02_75_12,xcond_1,GRCm39,501,704,1138,500,702,1135,1,2,3,2,75,12,A2,G3,A12
02_75_76,xcond_1,GRCm39,525,834,1326,525,834,1326,0,0,0,2,75,76,A2,G3,G4
02_75_93,xcond_1,GRCm39,845,1574,2475,844,1573,2474,1,1,1,2,75,93,A2,G3,H9
02_76_21,xcond_1,GRCm39,900,1316,2130,899,1315,2128,1,1,2,2,76,21,A2,G4,B9
02_76_43,xcond_1,GRCm39,421,566,932,421,566,932,0,0,0,2,76,43,A2,G4,D7
02_77_45,xcond_1,GRCm39,137,207,315,137,207,315,0,0,0,2,77,45,A2,G5,D9
02_77_69,xcond_1,GRCm39,640,835,1372,639,834,1370,1,1,2,2,77,69,A2,G5,F9
02_77_76,xcond_1,GRCm39,1027,1596,2576,1025,1594,2574,2,2,2,2,77,76,A2,G5,G4
02_78_05,xcond_1,GRCm39,526,703,1152,526,703,1152,0,0,0,2,78,5,A2,G6,A5
02_78_24,xcond_1,GRCm39,628,904,1452,627,903,1451,1,1,1,2,78,24,A2,G6,B12
02_78_28,xcond_1,GRCm39,312,388,660,312,388,660,0,0,0,2,78,28,A2,G6,C4
02_78_67,xcond_1,GRCm39,962,1684,2735,961,1683,2734,1,1,1,2,78,67,A2,G6,F7
02_79_21,xcond_1,GRCm39,826,1245,2071,825,1244,2069,1,1,2,2,79,21,A2,G7,B9
02_79_30,xcond_1,GRCm39,562,783,1316,562,783,1316,0,0,0,2,79,30,A2,G7,C6
02_79_45,xcond_1,GRCm39,3747,9335,15790,3741,9328,15780,6,7,10,2,79,45,A2,G7,D9
02_79_73,xcond_1,GRCm39,584,871,1454,584,871,1454,0,0,0,2,79,73,A2,G7,G1
02_79_93,xcond_1,GRCm39,323,407,661,323,407,661,0,0,0,2,79,93,A2,G7,H9
02_80_03,xcond_1,GRCm39,1103,1744,2901,1099,1740,2893,4,4,8,2,80,3,A2,G8,A3
02_80_29,xcond_1,GRCm39,560,733,1241,560,733,1241,0,0,0,2,80,29,A2,G8,C5
02_80_31,xcond_1,GRCm39,1235,2355,3808,1233,2351,3803,2,4,5,2,80,31,A2,G8,C7
02_80_54,xcond_1,GRCm39,510,646,1052,509,645,1051,1,1,1,2,80,54,A2,G8,E6
02_80_62,xcond_1,GRCm39,480,714,1224,480,714,1224,0,0,0,2,80,62,A2,G8,F2
02_80_84,xcond_1,GRCm39,405,568,916,404,566,913,1,2,3,2,80,84,A2,G8,G12
02_80_87,xcond_1,GRCm39,540,800,1313,538,798,1308,2,2,5,2,80,87,A2,G8,H3
02_81_21,xcond_1,GRCm39,491,734,1174,491,734,1174,0,0,0,2,81,21,A2,G9,B9
02_81_65,xcond_1,GRCm39,179,229,377,179,229,377,0,0,0,2,81,65,A2,G9,F5
02_81_88,xcond_1,GRCm39,483,615,1032,483,615,1032,0,0,0,2,81,88,A2,G9,H4
02_82_08,xcond_1,GRCm39,758,1385,2313,757,1383,2310,1,2,3,2,82,8,A2,G10,A8
02_82_96,xcond_1,GRCm39,332,478,818,317,463,795,15,15,23,2,82,96,A2,G10,H12
02_83_18,xcond_1,GRCm39,343,500,823,341,498,819,2,2,4,2,83,18,A2,G11,B6
02_83_44,xcond_1,GRCm39,969,1575,2560,966,1572,2557,3,3,3,2,83,44,A2,G11,D8
02_83_54,xcond_1,GRCm39,458,644,1067,458,644,1067,0,0,0,2,83,54,A2,G11,E6
02_83_69,xcond_1,GRCm39,291,369,582,289,367,579,2,2,3,2,83,69,A2,G11,F9
02_83_73,xcond_1,GRCm39,503,781,1220,501,779,1218,2,2,2,2,83,73,A2,G11,G1
02_83_84,xcond_1,GRCm39,901,1400,2333,900,1399,2332,1,1,1,2,83,84,A2,G11,G12
02_83_89,xcond_1,GRCm39,397,519,818,396,518,817,1,1,1,2,83,89,A2,G11,H5
02_84_81,xcond_1,GRCm39,322,428,684,322,428,684,0,0,0,2,84,81,A2,G12,G9
02_84_88,xcond_1,GRCm39,541,726,1163,540,725,1162,1,1,1,2,84,88,A2,G12,H4
02_85_09,xcond_1,GRCm39,218,295,464,218,295,464,0,0,0,2,85,9,A2,H1,A9
02_85_55,xcond_1,GRCm39,785,1178,1903,785,1178,1903,0,0,0,2,85,55,A2,H1,E7
02_86_60,xcond_1,GRCm39,325,394,672,324,393,671,1,1,1,2,86,60,A2,H2,E12
02_86_66,xcond_1,GRCm39,880,1329,2217,880,1329,2217,0,0,0,2,86,66,A2,H2,F6
02_86_71,xcond_1,GRCm39,383,527,855,383,527,855,0,0,0,2,86,71,A2,H2,F11
02_86_93,xcond_1,GRCm39,239,298,473,239,298,473,0,0,0,2,86,93,A2,H2,H9
02_87_37,xcond_1,GRCm39,400,563,871,400,563,871,0,0,0,2,87,37,A2,H3,D1
02_88_39,xcond_1,GRCm39,2557,5388,8680,2551,5379,8668,6,9,12,2,88,39,A2,H4,D3
02_88_44,xcond_1,GRCm39,77,206,283,76,205,282,1,1,1,2,88,44,A2,H4,D8
02_88_47,xcond_1,GRCm39,385,528,826,385,528,826,0,0,0,2,88,47,A2,H4,D11
02_88_69,xcond_1,GRCm39,251,338,553,251,338,553,0,0,0,2,88,69,A2,H4,F9
02_89_09,xcond_1,GRCm39,279,370,612,279,370,612,0,0,0,2,89,9,A2,H5,A9
02_89_15,xcond_1,GRCm39,313,455,754,313,455,754,0,0,0,2,89,15,A2,H5,B3
02_89_19,xcond_1,GRCm39,565,761,1194,565,761,1194,0,0,0,2,89,19,A2,H5,B7
02_89_28,xcond_1,GRCm39,1465,2864,4619,1465,2864,4619,0,0,0,2,89,28,A2,H5,C4
02_89_60,xcond_1,GRCm39,294,369,597,294,369,597,0,0,0,2,89,60,A2,H5,E12
02_89_62,xcond_1,GRCm39,531,800,1355,531,800,1355,0,0,0,2,89,62,A2,H5,F2
02_90_15,xcond_1,GRCm39,671,930,1520,671,930,1520,0,0,0,2,90,15,A2,H6,B3
02_90_30,xcond_1,GRCm39,604,833,1399,604,833,1399,0,0,0,2,90,30,A2,H6,C6
02_90_41,xcond_1,GRCm39,864,1214,2086,864,1214,2086,0,0,0,2,90,41,A2,H6,D5
02_90_53,xcond_1,GRCm39,559,936,1554,559,936,1554,0,0,0,2,90,53,A2,H6,E5
02_91_38,xcond_1,GRCm39,1572,2749,4575,1570,2745,4570,2,4,5,2,91,38,A2,H7,D2
02_91_41,xcond_1,GRCm39,754,1314,2097,752,1312,2091,2,2,6,2,91,41,A2,H7,D5
02_91_54,xcond_1,GRCm39,610,962,1585,609,961,1584,1,1,1,2,91,54,A2,H7,E6
02_92_37,xcond_1,GRCm39,520,770,1243,520,770,1243,0,0,0,2,92,37,A2,H8,D1
02_92_65,xcond_1,GRCm39,1130,1724,2866,1129,1723,2864,1,1,2,2,92,65,A2,H8,F5
02_92_81,xcond_1,GRCm39,433,598,995,432,597,994,1,1,1,2,92,81,A2,H8,G9
02_92_89,xcond_1,GRCm39,356,458,771,356,458,771,0,0,0,2,92,89,A2,H8,H5
02_93_01,xcond_1,GRCm39,518,770,1258,518,770,1258,0,0,0,2,93,1,A2,H9,A1
02_93_16,xcond_1,GRCm39,2381,5072,8197,2381,5072,8197,0,0,0,2,93,16,A2,H9,B4
02_93_47,xcond_1,GRCm39,638,998,1607,638,998,1607,0,0,0,2,93,47,A2,H9,D11
02_93_74,xcond_1,GRCm39,482,686,1140,481,685,1139,1,1,1,2,93,74,A2,H9,G2
02_94_09,xcond_1,GRCm39,1213,2001,3295,1211,1999,3291,2,2,4,2,94,9,A2,H10,A9
02_94_15,xcond_1,GRCm39,817,1330,2180,815,1326,2176,2,4,4,2,94,15,A2,H10,B3
02_94_45,xcond_1,GRCm39,449,614,1040,448,612,1038,1,2,2,2,94,45,A2,H10,D9
02_94_66,xcond_1,GRCm39,555,757,1253,555,757,1253,0,0,0,2,94,66,A2,H10,F6
02_94_68,xcond_1,GRCm39,748,1463,2392,747,1462,2391,1,1,1,2,94,68,A2,H10,F8
02_94_79,xcond_1,GRCm39,642,1082,1796,642,1082,1796,0,0,0,2,94,79,A2,H10,G7
02_94_85,xcond_1,GRCm39,699,1041,1681,698,1039,1677,1,2,4,2,94,85,A2,H10,H1
02_95_09,xcond_1,GRCm39,157,226,368,157,226,368,0,0,0,2,95,9,A2,H11,A9
02_95_33,xcond_1,GRCm39,295,469,756,295,469,756,0,0,0,2,95,33,A2,H11,C9
02_95_45,xcond_1,GRCm39,308,437,722,308,437,722,0,0,0,2,95,45,A2,H11,D9
02_95_49,xcond_1,GRCm39,1215,2116,3491,1210,2111,3485,5,5,6,2,95,49,A2,H11,E1
02_95_56,xcond_1,GRCm39,302,416,661,302,416,661,0,0,0,2,95,56,A2,H11,E8
02_95_76,xcond_1,GRCm39,612,944,1580,611,943,1579,1,1,1,2,95,76,A2,H11,G4
02_95_90,xcond_1,GRCm39,699,1023,1689,697,1021,1686,2,2,3,2,95,90,A2,H11,H6
02_95_96,xcond_1,GRCm39,267,359,593,267,359,593,0,0,0,2,95,96,A2,H11,H12
02_96_05,xcond_1,GRCm39,607,890,1439,607,890,1439,0,0,0,2,96,5,A2,H12,A5
02_96_24,xcond_1,GRCm39,1529,2714,4530,1526,2711,4527,3,3,3,2,96,24,A2,H12,B12
03_01_33,xcond_1,GRCm39,427,585,972,427,585,972,0,0,0,3,1,33,A3,A1,C9
03_01_81,xcond_1,GRCm39,335,434,731,334,433,730,1,1,1,3,1,81,A3,A1,G9
03_02_16,xcond_1,GRCm39,767,1229,1992,766,1228,1991,1,1,1,3,2,16,A3,A2,B4
03_02_20,xcond_1,GRCm39,410,510,845,410,510,845,0,0,0,3,2,20,A3,A2,B8
03_02_25,xcond_1,GRCm39,443,568,926,442,567,922,1,1,4,3,2,25,A3,A2,C1
03_02_32,xcond_1,GRCm39,618,982,1608,615,979,1604,3,3,4,3,2,32,A3,A2,C8
03_02_73,xcond_1,GRCm39,412,581,969,412,581,969,0,0,0,3,2,73,A3,A2,G1
03_02_95,xcond_1,GRCm39,198,375,620,197,374,619,1,1,1,3,2,95,A3,A2,H11
03_03_24,xcond_1,GRCm39,374,468,732,374,468,732,0,0,0,3,3,24,A3,A3,B12
03_03_45,xcond_1,GRCm39,449,613,1040,449,613,1040,0,0,0,3,3,45,A3,A3,D9
03_03_65,xcond_1,GRCm39,410,562,889,409,561,888,1,1,1,3,3,65,A3,A3,F5
03_04_53,xcond_1,GRCm39,655,1030,1733,653,1028,1731,2,2,2,3,4,53,A3,A4,E5
03_04_81,xcond_1,GRCm39,455,689,1135,455,689,1135,0,0,0,3,4,81,A3,A4,G9
03_04_83,xcond_1,GRCm39,697,1067,1820,695,1064,1814,2,3,6,3,4,83,A3,A4,G11
03_05_05,xcond_1,GRCm39,471,750,1245,471,750,1245,0,0,0,3,5,5,A3,A5,A5
03_05_19,xcond_1,GRCm39,1077,1887,3095,1074,1884,3089,3,3,6,3,5,19,A3,A5,B7
03_05_51,xcond_1,GRCm39,279,394,608,278,393,607,1,1,1,3,5,51,A3,A5,E3
03_05_81,xcond_1,GRCm39,331,432,731,331,432,731,0,0,0,3,5,81,A3,A5,G9
03_06_16,xcond_1,GRCm39,1038,1670,2764,1035,1666,2760,3,4,4,3,6,16,A3,A6,B4
03_06_44,xcond_1,GRCm39,455,571,958,454,570,956,1,1,2,3,6,44,A3,A6,D8
03_06_64,xcond_1,GRCm39,561,814,1336,560,813,1335,1,1,1,3,6,64,A3,A6,F4
03_06_89,xcond_1,GRCm39,774,1191,1978,773,1190,1977,1,1,1,3,6,89,A3,A6,H5
03_07_33,xcond_1,GRCm39,281,330,534,281,330,534,0,0,0,3,7,33,A3,A7,C9
03_07_45,xcond_1,GRCm39,1347,2209,3662,1347,2209,3662,0,0,0,3,7,45,A3,A7,D9
03_07_72,xcond_1,GRCm39,911,1721,2913,910,1720,2912,1,1,1,3,7,72,A3,A7,F12
03_07_80,xcond_1,GRCm39,568,788,1268,567,785,1262,1,3,6,3,7,80,A3,A7,G8
03_08_01,xcond_1,GRCm39,239,297,499,239,297,499,0,0,0,3,8,1,A3,A8,A1
03_08_18,xcond_1,GRCm39,677,1117,1804,677,1117,1804,0,0,0,3,8,18,A3,A8,B6
03_08_83,xcond_1,GRCm39,529,752,1287,529,752,1287,0,0,0,3,8,83,A3,A8,G11
03_08_87,xcond_1,GRCm39,818,1400,2213,817,1399,2212,1,1,1,3,8,87,A3,A8,H3
03_08_89,xcond_1,GRCm39,1290,1947,3160,1289,1945,3156,1,2,4,3,8,89,A3,A8,H5
03_09_29,xcond_1,GRCm39,471,789,1266,470,788,1265,1,1,1,3,9,29,A3,A9,C5
03_09_52,xcond_1,GRCm39,206,295,451,204,293,447,2,2,4,3,9,52,A3,A9,E4
03_10_33,xcond_1,GRCm39,408,557,933,408,557,933,0,0,0,3,10,33,A3,A10,C9
03_10_63,xcond_1,GRCm39,577,861,1407,576,860,1406,1,1,1,3,10,63,A3,A10,F3
03_10_66,xcond_1,GRCm39,1586,2548,4146,1584,2542,4137,2,6,9,3,10,66,A3,A10,F6
03_10_68,xcond_1,GRCm39,892,1467,2321,891,1466,2320,1,1,1,3,10,68,A3,A10,F8
03_12_14,xcond_1,GRCm39,649,933,1591,649,933,1591,0,0,0,3,12,14,A3,A12,B2
03_12_45,xcond_1,GRCm39,291,374,621,291,374,621,0,0,0,3,12,45,A3,A12,D9
03_13_09,xcond_1,GRCm39,460,669,1084,459,668,1083,1,1,1,3,13,9,A3,B1,A9
03_13_47,xcond_1,GRCm39,142,236,369,142,236,369,0,0,0,3,13,47,A3,B1,D11
03_14_32,xcond_1,GRCm39,409,579,947,406,576,944,3,3,3,3,14,32,A3,B2,C8
03_14_71,xcond_1,GRCm39,364,467,786,362,465,784,2,2,2,3,14,71,A3,B2,F11
03_14_74,xcond_1,GRCm39,372,503,805,372,503,805,0,0,0,3,14,74,A3,B2,G2
03_14_92,xcond_1,GRCm39,555,710,1160,555,710,1160,0,0,0,3,14,92,A3,B2,H8
03_15_09,xcond_1,GRCm39,369,468,729,368,467,728,1,1,1,3,15,9,A3,B3,A9
03_15_12,xcond_1,GRCm39,543,733,1214,542,732,1213,1,1,1,3,15,12,A3,B3,A12
03_15_51,xcond_1,GRCm39,341,427,712,341,427,712,0,0,0,3,15,51,A3,B3,E3
03_15_59,xcond_1,GRCm39,527,724,1162,527,724,1162,0,0,0,3,15,59,A3,B3,E11
03_15_79,xcond_1,GRCm39,2896,6229,10258,2893,6222,10247,3,7,11,3,15,79,A3,B3,G7
03_15_81,xcond_1,GRCm39,315,399,634,315,399,634,0,0,0,3,15,81,A3,B3,G9
03_16_62,xcond_1,GRCm39,1127,1801,3028,1127,1801,3028,0,0,0,3,16,62,A3,B4,F2
03_16_64,xcond_1,GRCm39,1593,2636,4305,1590,2628,4284,3,8,21,3,16,64,A3,B4,F4
03_18_02,xcond_1,GRCm39,465,796,1343,464,795,1340,1,1,3,3,18,2,A3,B6,A2
03_18_12,xcond_1,GRCm39,116,259,405,116,259,405,0,0,0,3,18,12,A3,B6,A12
03_18_57,xcond_1,GRCm39,1102,1971,3151,1101,1970,3149,1,1,2,3,18,57,A3,B6,E9
03_18_68,xcond_1,GRCm39,547,871,1360,546,870,1359,1,1,1,3,18,68,A3,B6,F8
03_18_95,xcond_1,GRCm39,415,602,964,414,601,962,1,1,2,3,18,95,A3,B6,H11
03_19_42,xcond_1,GRCm39,477,613,1014,477,613,1014,0,0,0,3,19,42,A3,B7,D6
03_19_77,xcond_1,GRCm39,358,454,733,357,453,732,1,1,1,3,19,77,A3,B7,G5
03_20_38,xcond_1,GRCm39,611,846,1373,610,845,1372,1,1,1,3,20,38,A3,B8,D2
03_20_49,xcond_1,GRCm39,962,1570,2532,961,1569,2531,1,1,1,3,20,49,A3,B8,E1
03_20_51,xcond_1,GRCm39,688,1063,1699,687,1062,1697,1,1,2,3,20,51,A3,B8,E3
03_20_60,xcond_1,GRCm39,471,683,1057,471,683,1057,0,0,0,3,20,60,A3,B8,E12
03_20_66,xcond_1,GRCm39,1428,2718,4335,1426,2716,4332,2,2,3,3,20,66,A3,B8,F6
03_20_72,xcond_1,GRCm39,342,419,709,342,419,709,0,0,0,3,20,72,A3,B8,F12
03_20_93,xcond_1,GRCm39,351,510,787,351,510,787,0,0,0,3,20,93,A3,B8,H9
03_20_95,xcond_1,GRCm39,1260,2046,3314,1258,2044,3310,2,2,4,3,20,95,A3,B8,H11
03_21_51,xcond_1,GRCm39,400,495,857,400,495,857,0,0,0,3,21,51,A3,B9,E3
03_21_60,xcond_1,GRCm39,350,454,742,350,454,742,0,0,0,3,21,60,A3,B9,E12
03_21_77,xcond_1,GRCm39,786,1218,2028,785,1217,2025,1,1,3,3,21,77,A3,B9,G5
03_22_27,xcond_1,GRCm39,427,561,902,427,561,902,0,0,0,3,22,27,A3,B10,C3
03_22_47,xcond_1,GRCm39,719,1290,2100,718,1288,2097,1,2,3,3,22,47,A3,B10,D11
03_22_67,xcond_1,GRCm39,468,654,1042,468,654,1042,0,0,0,3,22,67,A3,B10,F7
03_22_81,xcond_1,GRCm39,514,756,1232,514,756,1232,0,0,0,3,22,81,A3,B10,G9
03_22_89,xcond_1,GRCm39,470,624,1015,470,624,1015,0,0,0,3,22,89,A3,B10,H5
03_22_91,xcond_1,GRCm39,271,371,614,270,370,613,1,1,1,3,22,91,A3,B10,H7
03_23_59,xcond_1,GRCm39,522,674,1111,521,673,1109,1,1,2,3,23,59,A3,B11,E11
03_23_74,xcond_1,GRCm39,554,826,1313,554,826,1313,0,0,0,3,23,74,A3,B11,G2
03_24_47,xcond_1,GRCm39,394,518,829,394,518,829,0,0,0,3,24,47,A3,B12,D11
03_25_04,xcond_1,GRCm39,620,1030,1719,619,1029,1718,1,1,1,3,25,4,A3,C1,A4
03_25_15,xcond_1,GRCm39,373,520,836,372,519,835,1,1,1,3,25,15,A3,C1,B3
03_25_17,xcond_1,GRCm39,328,409,633,328,409,633,0,0,0,3,25,17,A3,C1,B5
03_25_41,xcond_1,GRCm39,233,302,532,231,300,529,2,2,3,3,25,41,A3,C1,D5
03_25_60,xcond_1,GRCm39,1133,2201,3682,1129,2191,3666,4,10,16,3,25,60,A3,C1,E12
03_26_68,xcond_1,GRCm39,94,246,381,94,246,381,0,0,0,3,26,68,A3,C2,F8
03_26_96,xcond_1,GRCm39,814,1165,1947,813,1164,1946,1,1,1,3,26,96,A3,C2,H12
03_27_88,xcond_1,GRCm39,1354,2669,4334,1353,2668,4332,1,1,2,3,27,88,A3,C3,H4
03_29_48,xcond_1,GRCm39,1614,3403,5512,1613,3402,5511,1,1,1,3,29,48,A3,C5,D12
03_29_78,xcond_1,GRCm39,833,1271,2126,832,1270,2124,1,1,2,3,29,78,A3,C5,G6
03_29_88,xcond_1,GRCm39,958,1481,2470,956,1479,2468,2,2,2,3,29,88,A3,C5,H4
03_29_90,xcond_1,GRCm39,1254,2382,3941,1253,2381,3938,1,1,3,3,29,90,A3,C5,H6
03_30_29,xcond_1,GRCm39,359,459,709,359,459,709,0,0,0,3,30,29,A3,C6,C5
03_30_33,xcond_1,GRCm39,328,461,770,327,460,769,1,1,1,3,30,33,A3,C6,C9
03_30_56,xcond_1,GRCm39,469,874,1354,468,873,1352,1,1,2,3,30,56,A3,C6,E8
03_30_78,xcond_1,GRCm39,624,872,1432,624,872,1432,0,0,0,3,30,78,A3,C6,G6
03_31_85,xcond_1,GRCm39,1180,1978,3211,1179,1977,3210,1,1,1,3,31,85,A3,C7,H1
03_32_09,xcond_1,GRCm39,463,635,1049,462,632,1043,1,3,6,3,32,9,A3,C8,A9
03_32_33,xcond_1,GRCm39,354,500,785,354,500,785,0,0,0,3,32,33,A3,C8,C9
03_32_36,xcond_1,GRCm39,1040,1697,2737,1038,1695,2735,2,2,2,3,32,36,A3,C8,C12
03_32_41,xcond_1,GRCm39,533,781,1268,531,779,1264,2,2,4,3,32,41,A3,C8,D5
03_32_43,xcond_1,GRCm39,499,710,1135,498,709,1134,1,1,1,3,32,43,A3,C8,D7
03_32_44,xcond_1,GRCm39,381,502,837,381,502,837,0,0,0,3,32,44,A3,C8,D8
03_32_72,xcond_1,GRCm39,127,288,496,126,287,494,1,1,2,3,32,72,A3,C8,F12
03_32_84,xcond_1,GRCm39,229,313,483,229,313,483,0,0,0,3,32,84,A3,C8,G12
03_33_25,xcond_1,GRCm39,458,581,915,458,581,915,0,0,0,3,33,25,A3,C9,C1
03_33_48,xcond_1,GRCm39,1567,2526,4130,1567,2526,4130,0,0,0,3,33,48,A3,C9,D12
03_33_87,xcond_1,GRCm39,696,1084,1851,695,1082,1849,1,2,2,3,33,87,A3,C9,H3
03_35_14,xcond_1,GRCm39,331,416,678,330,415,676,1,1,2,3,35,14,A3,C11,B2
03_35_24,xcond_1,GRCm39,599,843,1332,599,843,1332,0,0,0,3,35,24,A3,C11,B12
03_35_74,xcond_1,GRCm39,404,552,963,404,552,963,0,0,0,3,35,74,A3,C11,G2
03_36_01,xcond_1,GRCm39,1962,3544,5875,1960,3542,5873,2,2,2,3,36,1,A3,C12,A1
03_36_14,xcond_1,GRCm39,338,422,680,338,422,680,0,0,0,3,36,14,A3,C12,B2
03_36_52,xcond_1,GRCm39,957,1588,2465,956,1587,2464,1,1,1,3,36,52,A3,C12,E4
03_36_88,xcond_1,GRCm39,636,1026,1647,636,1026,1647,0,0,0,3,36,88,A3,C12,H4
03_37_36,xcond_1,GRCm39,533,794,1333,532,793,1332,1,1,1,3,37,36,A3,D1,C12
03_37_91,xcond_1,GRCm39,757,1117,1927,755,1115,1925,2,2,2,3,37,91,A3,D1,H7
03_38_51,xcond_1,GRCm39,620,857,1457,620,857,1457,0,0,0,3,38,51,A3,D2,E3
03_38_52,xcond_1,GRCm39,785,1189,1888,785,1189,1888,0,0,0,3,38,52,A3,D2,E4
03_38_67,xcond_1,GRCm39,585,793,1328,584,792,1327,1,1,1,3,38,67,A3,D2,F7
03_38_88,xcond_1,GRCm39,625,907,1488,625,907,1488,0,0,0,3,38,88,A3,D2,H4
03_39_33,xcond_1,GRCm39,457,687,1091,457,687,1091,0,0,0,3,39,33,A3,D3,C9
03_39_41,xcond_1,GRCm39,800,1166,1825,800,1166,1825,0,0,0,3,39,41,A3,D3,D5
03_39_57,xcond_1,GRCm39,266,306,484,266,306,484,0,0,0,3,39,57,A3,D3,E9
03_39_84,xcond_1,GRCm39,1332,2091,3410,1330,2089,3408,2,2,2,3,39,84,A3,D3,G12
03_40_48,xcond_1,GRCm39,452,620,1019,452,620,1019,0,0,0,3,40,48,A3,D4,D12
03_40_63,xcond_1,GRCm39,1254,2067,3441,1253,2065,3437,1,2,4,3,40,63,A3,D4,F3
03_40_74,xcond_1,GRCm39,932,1524,2560,930,1522,2558,2,2,2,3,40,74,A3,D4,G2
03_40_76,xcond_1,GRCm39,1174,1861,3033,1172,1858,3026,2,3,7,3,40,76,A3,D4,G4
03_41_02,xcond_1,GRCm39,373,481,800,373,481,800,0,0,0,3,41,2,A3,D5,A2
03_41_15,xcond_1,GRCm39,708,1153,1973,707,1151,1966,1,2,7,3,41,15,A3,D5,B3
03_41_47,xcond_1,GRCm39,442,764,1290,442,764,1290,0,0,0,3,41,47,A3,D5,D11
03_41_51,xcond_1,GRCm39,287,524,885,286,523,884,1,1,1,3,41,51,A3,D5,E3
03_42_05,xcond_1,GRCm39,802,1284,2059,801,1283,2057,1,1,2,3,42,5,A3,D6,A5
03_42_37,xcond_1,GRCm39,970,1553,2535,969,1551,2533,1,2,2,3,42,37,A3,D6,D1
03_42_44,xcond_1,GRCm39,1289,2426,3958,1289,2426,3958,0,0,0,3,42,44,A3,D6,D8
03_42_50,xcond_1,GRCm39,422,606,973,421,605,972,1,1,1,3,42,50,A3,D6,E2
03_42_56,xcond_1,GRCm39,661,1165,1917,660,1164,1916,1,1,1,3,42,56,A3,D6,E8
03_42_60,xcond_1,GRCm39,522,748,1219,521,747,1217,1,1,2,3,42,60,A3,D6,E12
03_42_61,xcond_1,GRCm39,274,388,602,274,388,602,0,0,0,3,42,61,A3,D6,F1
03_42_68,xcond_1,GRCm39,846,1298,1999,844,1294,1994,2,4,5,3,42,68,A3,D6,F8
03_42_69,xcond_1,GRCm39,277,424,697,277,424,697,0,0,0,3,42,69,A3,D6,F9
03_42_81,xcond_1,GRCm39,295,399,644,295,399,644,0,0,0,3,42,81,A3,D6,G9
03_43_04,xcond_1,GRCm39,703,1215,2038,702,1214,2037,1,1,1,3,43,4,A3,D7,A4
03_43_21,xcond_1,GRCm39,283,379,622,283,379,622,0,0,0,3,43,21,A3,D7,B9
03_43_37,xcond_1,GRCm39,592,819,1377,591,818,1376,1,1,1,3,43,37,A3,D7,D1
03_43_38,xcond_1,GRCm39,1713,3047,5097,1713,3047,5097,0,0,0,3,43,38,A3,D7,D2
03_43_79,xcond_1,GRCm39,902,1448,2392,901,1446,2389,1,2,3,3,43,79,A3,D7,G7
03_43_96,xcond_1,GRCm39,878,1284,2059,877,1283,2057,1,1,2,3,43,96,A3,D7,H12
03_44_59,xcond_1,GRCm39,476,634,1027,476,634,1027,0,0,0,3,44,59,A3,D8,E11
03_44_79,xcond_1,GRCm39,671,1128,1791,670,1124,1785,1,4,6,3,44,79,A3,D8,G7
03_44_89,xcond_1,GRCm39,728,1193,1923,727,1192,1922,1,1,1,3,44,89,A3,D8,H5
03_45_65,xcond_1,GRCm39,461,670,1060,460,669,1059,1,1,1,3,45,65,A3,D9,F5
03_45_89,xcond_1,GRCm39,427,558,945,426,556,941,1,2,4,3,45,89,A3,D9,H5
03_46_20,xcond_1,GRCm39,831,1116,1863,830,1115,1862,1,1,1,3,46,20,A3,D10,B8
03_46_33,xcond_1,GRCm39,261,486,799,260,485,798,1,1,1,3,46,33,A3,D10,C9
03_46_54,xcond_1,GRCm39,598,882,1466,598,882,1466,0,0,0,3,46,54,A3,D10,E6
03_46_90,xcond_1,GRCm39,522,742,1265,520,739,1261,2,3,4,3,46,90,A3,D10,H6
03_47_09,xcond_1,GRCm39,548,751,1282,548,751,1282,0,0,0,3,47,9,A3,D11,A9
03_47_55,xcond_1,GRCm39,423,549,876,422,548,875,1,1,1,3,47,55,A3,D11,E7
03_47_61,xcond_1,GRCm39,442,613,975,442,613,975,0,0,0,3,47,61,A3,D11,F1
03_48_21,xcond_1,GRCm39,201,277,451,200,276,450,1,1,1,3,48,21,A3,D12,B9
03_48_28,xcond_1,GRCm39,632,940,1521,632,940,1521,0,0,0,3,48,28,A3,D12,C4
03_48_30,xcond_1,GRCm39,229,298,465,229,298,465,0,0,0,3,48,30,A3,D12,C6
03_48_86,xcond_1,GRCm39,1168,1950,3238,1166,1948,3235,2,2,3,3,48,86,A3,D12,H2
03_48_88,xcond_1,GRCm39,503,706,1200,503,706,1200,0,0,0,3,48,88,A3,D12,H4
03_49_27,xcond_1,GRCm39,2067,4209,6833,2064,4206,6830,3,3,3,3,49,27,A3,E1,C3
03_49_42,xcond_1,GRCm39,263,335,597,261,333,593,2,2,4,3,49,42,A3,E1,D6
03_49_45,xcond_1,GRCm39,340,513,802,340,513,802,0,0,0,3,49,45,A3,E1,D9
03_49_66,xcond_1,GRCm39,429,579,962,428,577,958,1,2,4,3,49,66,A3,E1,F6
03_49_78,xcond_1,GRCm39,376,513,830,376,513,830,0,0,0,3,49,78,A3,E1,G6
03_49_93,xcond_1,GRCm39,565,829,1406,564,828,1405,1,1,1,3,49,93,A3,E1,H9
03_50_06,xcond_1,GRCm39,416,539,913,416,539,913,0,0,0,3,50,6,A3,E2,A6
03_50_23,xcond_1,GRCm39,687,978,1608,685,976,1606,2,2,2,3,50,23,A3,E2,B11
03_50_27,xcond_1,GRCm39,323,391,613,323,391,613,0,0,0,3,50,27,A3,E2,C3
03_50_48,xcond_1,GRCm39,964,1535,2550,963,1534,2549,1,1,1,3,50,48,A3,E2,D12
03_50_49,xcond_1,GRCm39,408,586,967,408,586,967,0,0,0,3,50,49,A3,E2,E1
03_51_29,xcond_1,GRCm39,294,353,584,294,353,584,0,0,0,3,51,29,A3,E3,C5
03_51_63,xcond_1,GRCm39,308,380,618,307,379,616,1,1,2,3,51,63,A3,E3,F3
03_51_93,xcond_1,GRCm39,207,267,450,207,267,450,0,0,0,3,51,93,A3,E3,H9
03_52_23,xcond_1,GRCm39,1785,3761,6245,1783,3759,6242,2,2,3,3,52,23,A3,E4,B11
03_52_25,xcond_1,GRCm39,698,1003,1608,698,1003,1608,0,0,0,3,52,25,A3,E4,C1
03_52_42,xcond_1,GRCm39,596,847,1340,595,846,1339,1,1,1,3,52,42,A3,E4,D6
03_53_42,xcond_1,GRCm39,597,859,1389,596,858,1388,1,1,1,3,53,42,A3,E5,D6
03_53_53,xcond_1,GRCm39,619,916,1547,618,915,1546,1,1,1,3,53,53,A3,E5,E5
03_53_80,xcond_1,GRCm39,182,765,1226,181,764,1224,1,1,2,3,53,80,A3,E5,G8
03_54_35,xcond_1,GRCm39,443,603,957,442,602,952,1,1,5,3,54,35,A3,E6,C11
03_54_51,xcond_1,GRCm39,479,770,1278,478,769,1277,1,1,1,3,54,51,A3,E6,E3
03_54_54,xcond_1,GRCm39,1276,1954,3198,1274,1952,3196,2,2,2,3,54,54,A3,E6,E6
03_55_18,xcond_1,GRCm39,489,654,1125,488,652,1120,1,2,5,3,55,18,A3,E7,B6
03_55_42,xcond_1,GRCm39,228,299,498,227,298,495,1,1,3,3,55,42,A3,E7,D6
03_55_95,xcond_1,GRCm39,226,286,471,226,286,471,0,0,0,3,55,95,A3,E7,H11
03_56_72,xcond_1,GRCm39,692,1113,1907,690,1110,1902,2,3,5,3,56,72,A3,E8,F12
03_57_09,xcond_1,GRCm39,448,701,1180,447,700,1179,1,1,1,3,57,9,A3,E9,A9
03_57_50,xcond_1,GRCm39,329,454,777,329,454,777,0,0,0,3,57,50,A3,E9,E2
03_57_60,xcond_1,GRCm39,451,614,1032,451,614,1032,0,0,0,3,57,60,A3,E9,E12
03_57_91,xcond_1,GRCm39,538,718,1164,538,718,1164,0,0,0,3,57,91,A3,E9,H7
03_58_21,xcond_1,GRCm39,289,355,549,288,354,548,1,1,1,3,58,21,A3,E10,B9
03_58_36,xcond_1,GRCm39,300,384,613,300,384,613,0,0,0,3,58,36,A3,E10,C12
03_58_52,xcond_1,GRCm39,245,335,513,245,335,513,0,0,0,3,58,52,A3,E10,E4
03_58_64,xcond_1,GRCm39,175,249,388,174,248,387,1,1,1,3,58,64,A3,E10,F4
03_58_96,xcond_1,GRCm39,964,1637,2686,963,1636,2684,1,1,2,3,58,96,A3,E10,H12
03_59_19,xcond_1,GRCm39,324,411,655,324,411,655,0,0,0,3,59,19,A3,E11,B7
03_59_20,xcond_1,GRCm39,537,745,1268,536,744,1266,1,1,2,3,59,20,A3,E11,B8
03_59_50,xcond_1,GRCm39,2178,4099,6951,2176,4096,6947,2,3,4,3,59,50,A3,E11,E2
03_61_02,xcond_1,GRCm39,646,908,1513,645,907,1512,1,1,1,3,61,2,A3,F1,A2
03_61_05,xcond_1,GRCm39,835,1405,2321,834,1404,2319,1,1,2,3,61,5,A3,F1,A5
03_61_07,xcond_1,GRCm39,1551,2774,4466,1548,2770,4460,3,4,6,3,61,7,A3,F1,A7
03_61_50,xcond_1,GRCm39,511,793,1322,511,793,1322,0,0,0,3,61,50,A3,F1,E2
03_61_72,xcond_1,GRCm39,525,704,1221,525,704,1221,0,0,0,3,61,72,A3,F1,F12
03_61_87,xcond_1,GRCm39,558,749,1216,558,749,1216,0,0,0,3,61,87,A3,F1,H3
03_63_12,xcond_1,GRCm39,574,842,1354,573,841,1353,1,1,1,3,63,12,A3,F3,A12
03_63_26,xcond_1,GRCm39,1187,1790,2963,1185,1786,2958,2,4,5,3,63,26,A3,F3,C2
03_63_74,xcond_1,GRCm39,787,1200,2042,787,1200,2042,0,0,0,3,63,74,A3,F3,G2
03_63_81,xcond_1,GRCm39,307,368,592,304,365,586,3,3,6,3,63,81,A3,F3,G9
03_64_26,xcond_1,GRCm39,632,891,1472,632,891,1472,0,0,0,3,64,26,A3,F4,C2
03_64_36,xcond_1,GRCm39,420,543,898,419,542,897,1,1,1,3,64,36,A3,F4,C12
03_64_44,xcond_1,GRCm39,323,400,685,322,399,683,1,1,2,3,64,44,A3,F4,D8
03_64_48,xcond_1,GRCm39,426,628,1008,425,626,1006,1,2,2,3,64,48,A3,F4,D12
03_64_50,xcond_1,GRCm39,578,827,1478,578,827,1478,0,0,0,3,64,50,A3,F4,E2
03_64_67,xcond_1,GRCm39,617,852,1382,617,852,1382,0,0,0,3,64,67,A3,F4,F7
03_64_96,xcond_1,GRCm39,511,783,1337,510,782,1335,1,1,2,3,64,96,A3,F4,H12
03_65_11,xcond_1,GRCm39,555,752,1265,555,752,1265,0,0,0,3,65,11,A3,F5,A11
03_65_31,xcond_1,GRCm39,1166,1863,3161,1166,1863,3161,0,0,0,3,65,31,A3,F5,C7
03_65_40,xcond_1,GRCm39,2596,6191,10517,2594,6189,10514,2,2,3,3,65,40,A3,F5,D4
03_65_47,xcond_1,GRCm39,996,1791,3005,996,1791,3005,0,0,0,3,65,47,A3,F5,D11
03_65_78,xcond_1,GRCm39,355,501,843,355,501,843,0,0,0,3,65,78,A3,F5,G6
03_65_81,xcond_1,GRCm39,423,547,958,423,547,958,0,0,0,3,65,81,A3,F5,G9
03_66_02,xcond_1,GRCm39,590,838,1481,590,838,1481,0,0,0,3,66,2,A3,F6,A2
03_66_19,xcond_1,GRCm39,86,421,718,85,420,717,1,1,1,3,66,19,A3,F6,B7
03_66_33,xcond_1,GRCm39,606,890,1540,606,890,1540,0,0,0,3,66,33,A3,F6,C9
03_66_48,xcond_1,GRCm39,724,1102,1859,723,1101,1858,1,1,1,3,66,48,A3,F6,D12
03_66_66,xcond_1,GRCm39,679,976,1667,676,973,1664,3,3,3,3,66,66,A3,F6,F6
03_67_27,xcond_1,GRCm39,500,668,1034,500,668,1034,0,0,0,3,67,27,A3,F7,C3
03_67_51,xcond_1,GRCm39,1345,2214,3682,1343,2212,3680,2,2,2,3,67,51,A3,F7,E3
03_67_56,xcond_1,GRCm39,945,1417,2392,943,1415,2389,2,2,3,3,67,56,A3,F7,E8
03_67_62,xcond_1,GRCm39,670,1033,1685,669,1032,1682,1,1,3,3,67,62,A3,F7,F2
03_67_71,xcond_1,GRCm39,1115,1929,3189,1112,1926,3186,3,3,3,3,67,71,A3,F7,F11
03_67_72,xcond_1,GRCm39,2357,4629,7915,2351,4616,7896,6,13,19,3,67,72,A3,F7,F12
03_67_74,xcond_1,GRCm39,633,846,1407,631,844,1404,2,2,3,3,67,74,A3,F7,G2
03_68_59,xcond_1,GRCm39,928,1461,2392,927,1460,2391,1,1,1,3,68,59,A3,F8,E11
03_68_88,xcond_1,GRCm39,448,671,1106,448,671,1106,0,0,0,3,68,88,A3,F8,H4
03_68_95,xcond_1,GRCm39,1948,3433,5686,1946,3430,5682,2,3,4,3,68,95,A3,F8,H11
03_69_12,xcond_1,GRCm39,2216,5242,8724,2212,5238,8717,4,4,7,3,69,12,A3,F9,A12
03_69_28,xcond_1,GRCm39,246,304,479,246,304,479,0,0,0,3,69,28,A3,F9,C4
03_69_33,xcond_1,GRCm39,712,1012,1602,711,1011,1596,1,1,6,3,69,33,A3,F9,C9
03_69_41,xcond_1,GRCm39,179,228,349,178,227,346,1,1,3,3,69,41,A3,F9,D5
03_69_96,xcond_1,GRCm39,921,1508,2465,921,1508,2465,0,0,0,3,69,96,A3,F9,H12
03_70_25,xcond_1,GRCm39,780,1120,1824,779,1119,1823,1,1,1,3,70,25,A3,F10,C1
03_70_38,xcond_1,GRCm39,834,1596,2608,832,1594,2605,2,2,3,3,70,38,A3,F10,D2
03_70_40,xcond_1,GRCm39,521,674,1139,519,672,1137,2,2,2,3,70,40,A3,F10,D4
03_70_78,xcond_1,GRCm39,421,555,944,420,554,942,1,1,2,3,70,78,A3,F10,G6
03_71_05,xcond_1,GRCm39,298,402,663,298,402,663,0,0,0,3,71,5,A3,F11,A5
03_71_24,xcond_1,GRCm39,634,852,1411,633,850,1407,1,2,4,3,71,24,A3,F11,B12
03_71_50,xcond_1,GRCm39,435,548,896,435,548,896,0,0,0,3,71,50,A3,F11,E2
03_71_57,xcond_1,GRCm39,302,405,644,302,405,644,0,0,0,3,71,57,A3,F11,E9
03_71_63,xcond_1,GRCm39,189,387,647,189,387,647,0,0,0,3,71,63,A3,F11,F3
03_71_69,xcond_1,GRCm39,440,601,992,439,600,991,1,1,1,3,71,69,A3,F11,F9
03_73_09,xcond_1,GRCm39,575,839,1414,574,838,1413,1,1,1,3,73,9,A3,G1,A9
03_73_47,xcond_1,GRCm39,413,595,965,412,594,964,1,1,1,3,73,47,A3,G1,D11
03_74_11,xcond_1,GRCm39,3241,7913,12868,3238,7907,12860,3,6,8,3,74,11,A3,G2,A11
03_74_23,xcond_1,GRCm39,2364,4906,8023,2363,4905,8022,1,1,1,3,74,23,A3,G2,B11
03_74_24,xcond_1,GRCm39,457,610,1017,457,610,1017,0,0,0,3,74,24,A3,G2,B12
03_74_68,xcond_1,GRCm39,471,602,994,471,602,994,0,0,0,3,74,68,A3,G2,F8
03_74_84,xcond_1,GRCm39,489,691,1079,489,691,1079,0,0,0,3,74,84,A3,G2,G12
03_75_18,xcond_1,GRCm39,555,743,1260,555,743,1260,0,0,0,3,75,18,A3,G3,B6
03_75_23,xcond_1,GRCm39,360,485,806,360,485,806,0,0,0,3,75,23,A3,G3,B11
03_75_37,xcond_1,GRCm39,398,523,835,398,523,835,0,0,0,3,75,37,A3,G3,D1
03_75_48,xcond_1,GRCm39,1239,2076,3452,1238,2075,3451,1,1,1,3,75,48,A3,G3,D12
03_75_72,xcond_1,GRCm39,496,665,1104,496,665,1104,0,0,0,3,75,72,A3,G3,F12
03_75_88,xcond_1,GRCm39,178,258,437,178,258,437,0,0,0,3,75,88,A3,G3,H4
03_76_08,xcond_1,GRCm39,395,540,904,394,539,902,1,1,2,3,76,8,A3,G4,A8
03_76_15,xcond_1,GRCm39,560,837,1387,559,836,1386,1,1,1,3,76,15,A3,G4,B3
03_76_19,xcond_1,GRCm39,984,1625,2784,983,1623,2782,1,2,2,3,76,19,A3,G4,B7
03_76_33,xcond_1,GRCm39,202,265,446,202,265,446,0,0,0,3,76,33,A3,G4,C9
03_76_57,xcond_1,GRCm39,554,797,1265,554,797,1265,0,0,0,3,76,57,A3,G4,E9
03_76_68,xcond_1,GRCm39,422,564,898,422,564,898,0,0,0,3,76,68,A3,G4,F8
03_77_43,xcond_1,GRCm39,968,1569,2505,967,1567,2503,1,2,2,3,77,43,A3,G5,D7
03_78_72,xcond_1,GRCm39,289,398,653,289,398,653,0,0,0,3,78,72,A3,G6,F12
03_78_96,xcond_1,GRCm39,278,356,577,278,356,577,0,0,0,3,78,96,A3,G6,H12
03_79_06,xcond_1,GRCm39,290,386,651,290,386,651,0,0,0,3,79,6,A3,G7,A6
03_79_08,xcond_1,GRCm39,532,780,1344,531,779,1342,1,1,2,3,79,8,A3,G7,A8
03_79_12,xcond_1,GRCm39,494,676,1128,494,676,1128,0,0,0,3,79,12,A3,G7,A12
03_79_26,xcond_1,GRCm39,1047,1602,2661,1044,1599,2656,3,3,5,3,79,26,A3,G7,C2
03_79_56,xcond_1,GRCm39,849,1342,2254,848,1340,2249,1,2,5,3,79,56,A3,G7,E8
03_79_66,xcond_1,GRCm39,307,417,662,307,417,662,0,0,0,3,79,66,A3,G7,F6
03_79_69,xcond_1,GRCm39,250,313,485,250,313,485,0,0,0,3,79,69,A3,G7,F9
03_79_71,xcond_1,GRCm39,430,568,935,430,568,935,0,0,0,3,79,71,A3,G7,F11
03_80_19,xcond_1,GRCm39,371,484,774,371,484,774,0,0,0,3,80,19,A3,G8,B7
03_80_30,xcond_1,GRCm39,603,1051,1725,601,1049,1723,2,2,2,3,80,30,A3,G8,C6
03_80_40,xcond_1,GRCm39,506,703,1162,506,703,1162,0,0,0,3,80,40,A3,G8,D4
03_80_87,xcond_1,GRCm39,348,486,807,348,486,807,0,0,0,3,80,87,A3,G8,H3
03_81_29,xcond_1,GRCm39,512,702,1165,512,702,1165,0,0,0,3,81,29,A3,G9,C5
03_81_32,xcond_1,GRCm39,638,913,1526,637,912,1525,1,1,1,3,81,32,A3,G9,C8
03_82_08,xcond_1,GRCm39,831,1260,1965,831,1260,1965,0,0,0,3,82,8,A3,G10,A8
03_82_17,xcond_1,GRCm39,731,1162,1867,730,1161,1866,1,1,1,3,82,17,A3,G10,B5
03_82_27,xcond_1,GRCm39,764,1185,1962,764,1185,1962,0,0,0,3,82,27,A3,G10,C3
03_82_57,xcond_1,GRCm39,341,464,730,340,463,729,1,1,1,3,82,57,A3,G10,E9
03_83_16,xcond_1,GRCm39,355,522,817,353,518,809,2,4,8,3,83,16,A3,G11,B4
03_84_28,xcond_1,GRCm39,400,525,862,400,525,862,0,0,0,3,84,28,A3,G12,C4
03_84_93,xcond_1,GRCm39,393,548,903,393,548,903,0,0,0,3,84,93,A3,G12,H9
03_85_12,xcond_1,GRCm39,446,597,988,445,596,987,1,1,1,3,85,12,A3,H1,A12
03_85_14,xcond_1,GRCm39,683,1215,2000,683,1215,2000,0,0,0,3,85,14,A3,H1,B2
03_85_23,xcond_1,GRCm39,599,868,1425,598,867,1424,1,1,1,3,85,23,A3,H1,B11
03_86_14,xcond_1,GRCm39,792,1114,1828,791,1113,1827,1,1,1,3,86,14,A3,H2,B2
03_86_64,xcond_1,GRCm39,828,1325,2146,827,1324,2145,1,1,1,3,86,64,A3,H2,F4
03_86_69,xcond_1,GRCm39,256,332,527,255,331,526,1,1,1,3,86,69,A3,H2,F9
03_86_71,xcond_1,GRCm39,342,467,778,342,467,778,0,0,0,3,86,71,A3,H2,F11
03_87_17,xcond_1,GRCm39,763,1034,1623,762,1033,1622,1,1,1,3,87,17,A3,H3,B5
03_87_50,xcond_1,GRCm39,464,637,1012,462,634,1007,2,3,5,3,87,50,A3,H3,E2
03_88_18,xcond_1,GRCm39,772,1267,2090,771,1266,2089,1,1,1,3,88,18,A3,H4,B6
03_88_35,xcond_1,GRCm39,514,684,1070,514,684,1070,0,0,0,3,88,35,A3,H4,C11
03_88_59,xcond_1,GRCm39,1770,3154,5004,1768,3152,5000,2,2,4,3,88,59,A3,H4,E11
03_89_35,xcond_1,GRCm39,1069,1823,3000,1068,1822,2999,1,1,1,3,89,35,A3,H5,C11
03_89_75,xcond_1,GRCm39,179,208,333,179,208,333,0,0,0,3,89,75,A3,H5,G3
03_90_03,xcond_1,GRCm39,1273,2428,4088,1272,2427,4086,1,1,2,3,90,3,A3,H6,A3
03_90_08,xcond_1,GRCm39,2825,6596,11395,2822,6589,11384,3,7,11,3,90,8,A3,H6,A8
03_90_09,xcond_1,GRCm39,558,763,1258,558,763,1258,0,0,0,3,90,9,A3,H6,A9
03_90_24,xcond_1,GRCm39,250,306,516,250,306,516,0,0,0,3,90,24,A3,H6,B12
03_90_38,xcond_1,GRCm39,1194,1842,3132,1194,1842,3132,0,0,0,3,90,38,A3,H6,D2
03_90_45,xcond_1,GRCm39,462,598,979,462,598,979,0,0,0,3,90,45,A3,H6,D9
03_90_61,xcond_1,GRCm39,504,772,1283,504,772,1283,0,0,0,3,90,61,A3,H6,F1
03_90_86,xcond_1,GRCm39,512,699,1158,511,698,1157,1,1,1,3,90,86,A3,H6,H2
03_90_88,xcond_1,GRCm39,1082,1937,3195,1081,1936,3193,1,1,2,3,90,88,A3,H6,H4
03_91_09,xcond_1,GRCm39,314,400,644,314,400,644,0,0,0,3,91,9,A3,H7,A9
03_91_21,xcond_1,GRCm39,373,491,837,373,491,837,0,0,0,3,91,21,A3,H7,B9
03_91_26,xcond_1,GRCm39,1036,1569,2594,1036,1569,2594,0,0,0,3,91,26,A3,H7,C2
03_91_50,xcond_1,GRCm39,549,791,1328,549,791,1328,0,0,0,3,91,50,A3,H7,E2
03_91_96,xcond_1,GRCm39,714,1016,1705,713,1015,1704,1,1,1,3,91,96,A3,H7,H12
03_92_47,xcond_1,GRCm39,385,485,812,385,485,812,0,0,0,3,92,47,A3,H8,D11
03_92_53,xcond_1,GRCm39,395,540,856,394,539,853,1,1,3,3,92,53,A3,H8,E5
03_93_07,xcond_1,GRCm39,1683,2918,4729,1681,2915,4725,2,3,4,3,93,7,A3,H9,A7
03_93_39,xcond_1,GRCm39,882,1465,2339,880,1463,2336,2,2,3,3,93,39,A3,H9,D3
03_93_76,xcond_1,GRCm39,515,757,1170,515,757,1170,0,0,0,3,93,76,A3,H9,G4
03_93_78,xcond_1,GRCm39,340,458,711,340,458,711,0,0,0,3,93,78,A3,H9,G6
03_94_08,xcond_1,GRCm39,1060,1831,3048,1059,1830,3047,1,1,1,3,94,8,A3,H10,A8
03_94_13,xcond_1,GRCm39,1119,1929,3155,1118,1925,3149,1,4,6,3,94,13,A3,H10,B1
03_94_35,xcond_1,GRCm39,534,767,1237,534,767,1237,0,0,0,3,94,35,A3,H10,C11
03_94_48,xcond_1,GRCm39,532,771,1314,532,771,1314,0,0,0,3,94,48,A3,H10,D12
03_94_83,xcond_1,GRCm39,448,577,938,447,576,936,1,1,2,3,94,83,A3,H10,G11
03_94_90,xcond_1,GRCm39,1212,2335,3847,1210,2333,3845,2,2,2,3,94,90,A3,H10,H6
03_94_93,xcond_1,GRCm39,637,870,1462,636,869,1459,1,1,3,3,94,93,A3,H10,H9
03_95_04,xcond_1,GRCm39,234,297,501,232,295,495,2,2,6,3,95,4,A3,H11,A4
03_95_54,xcond_1,GRCm39,301,415,698,300,413,693,1,2,5,3,95,54,A3,H11,E6
03_95_75,xcond_1,GRCm39,399,560,936,399,560,936,0,0,0,3,95,75,A3,H11,G3
03_95_80,xcond_1,GRCm39,365,491,808,365,491,808,0,0,0,3,95,80,A3,H11,G8
03_95_84,xcond_1,GRCm39,309,414,689,309,414,689,0,0,0,3,95,84,A3,H11,G12
03_95_90,xcond_1,GRCm39,612,860,1464,612,860,1464,0,0,0,3,95,90,A3,H11,H6
04_01_59,xcond_1,GRCm39,367,505,789,367,505,789,0,0,0,4,1,59,A4,A1,E11
04_01_72,xcond_1,GRCm39,676,1025,1696,676,1025,1696,0,0,0,4,1,72,A4,A1,F12
04_01_77,xcond_1,GRCm39,1946,3509,5837,1946,3509,5837,0,0,0,4,1,77,A4,A1,G5
04_02_17,xcond_1,GRCm39,361,508,835,361,508,835,0,0,0,4,2,17,A4,A2,B5
04_02_66,xcond_1,GRCm39,674,1071,1752,674,1071,1752,0,0,0,4,2,66,A4,A2,F6
04_02_95,xcond_1,GRCm39,258,298,512,258,298,512,0,0,0,4,2,95,A4,A2,H11
04_03_02,xcond_1,GRCm39,182,210,357,182,210,357,0,0,0,4,3,2,A4,A3,A2
04_03_25,xcond_1,GRCm39,546,788,1257,543,785,1251,3,3,6,4,3,25,A4,A3,C1
04_04_05,xcond_1,GRCm39,508,718,1243,507,717,1242,1,1,1,4,4,5,A4,A4,A5
04_04_12,xcond_1,GRCm39,1147,2059,3421,1146,2058,3420,1,1,1,4,4,12,A4,A4,A12
04_04_49,xcond_1,GRCm39,364,561,919,364,561,919,0,0,0,4,4,49,A4,A4,E1
04_04_74,xcond_1,GRCm39,510,686,1133,509,685,1131,1,1,2,4,4,74,A4,A4,G2
04_04_84,xcond_1,GRCm39,464,636,1055,463,635,1054,1,1,1,4,4,84,A4,A4,G12
04_05_20,xcond_1,GRCm39,329,421,670,328,420,669,1,1,1,4,5,20,A4,A5,B8
04_05_32,xcond_1,GRCm39,370,518,842,369,517,838,1,1,4,4,5,32,A4,A5,C8
04_05_48,xcond_1,GRCm39,392,454,727,392,454,727,0,0,0,4,5,48,A4,A5,D12
04_05_51,xcond_1,GRCm39,750,1359,2156,749,1358,2155,1,1,1,4,5,51,A4,A5,E3
04_05_89,xcond_1,GRCm39,254,544,853,254,544,853,0,0,0,4,5,89,A4,A5,H5
04_06_04,xcond_1,GRCm39,386,522,793,386,522,793,0,0,0,4,6,4,A4,A6,A4
04_06_21,xcond_1,GRCm39,772,1018,1714,772,1018,1714,0,0,0,4,6,21,A4,A6,B9
04_06_31,xcond_1,GRCm39,1144,1927,3100,1141,1924,3092,3,3,8,4,6,31,A4,A6,C7
04_06_33,xcond_1,GRCm39,338,432,696,338,432,696,0,0,0,4,6,33,A4,A6,C9
04_06_36,xcond_1,GRCm39,683,1001,1660,682,1000,1657,1,1,3,4,6,36,A4,A6,C12
04_06_63,xcond_1,GRCm39,584,791,1348,583,789,1346,1,2,2,4,6,63,A4,A6,F3
04_07_04,xcond_1,GRCm39,790,1329,2224,790,1329,2224,0,0,0,4,7,4,A4,A7,A4
04_07_28,xcond_1,GRCm39,319,395,636,318,394,634,1,1,2,4,7,28,A4,A7,C4
04_07_45,xcond_1,GRCm39,308,377,623,308,377,623,0,0,0,4,7,45,A4,A7,D9
04_07_61,xcond_1,GRCm39,561,863,1449,561,863,1449,0,0,0,4,7,61,A4,A7,F1
04_08_29,xcond_1,GRCm39,595,878,1416,594,877,1415,1,1,1,4,8,29,A4,A8,C5
04_08_52,xcond_1,GRCm39,907,1532,2450,904,1528,2443,3,4,7,4,8,52,A4,A8,E4
04_09_32,xcond_1,GRCm39,847,1377,2314,847,1377,2314,0,0,0,4,9,32,A4,A9,C8
04_09_77,xcond_1,GRCm39,1610,3035,4927,1608,3033,4925,2,2,2,4,9,77,A4,A9,G5
04_09_85,xcond_1,GRCm39,365,459,757,365,459,757,0,0,0,4,9,85,A4,A9,H1
04_10_17,xcond_1,GRCm39,482,633,989,482,633,989,0,0,0,4,10,17,A4,A10,B5
04_10_30,xcond_1,GRCm39,591,760,1223,590,759,1222,1,1,1,4,10,30,A4,A10,C6
04_10_42,xcond_1,GRCm39,860,1314,2197,858,1312,2192,2,2,5,4,10,42,A4,A10,D6
04_10_43,xcond_1,GRCm39,741,1044,1727,739,1041,1721,2,3,6,4,10,43,A4,A10,D7
04_10_55,xcond_1,GRCm39,474,630,1040,473,629,1039,1,1,1,4,10,55,A4,A10,E7
04_11_79,xcond_1,GRCm39,646,942,1502,645,941,1499,1,1,3,4,11,79,A4,A11,G7
04_12_11,xcond_1,GRCm39,1132,1791,2985,1132,1791,2985,0,0,0,4,12,11,A4,A12,A11
04_12_28,xcond_1,GRCm39,598,849,1366,597,848,1365,1,1,1,4,12,28,A4,A12,C4
04_12_29,xcond_1,GRCm39,840,1343,2217,838,1341,2214,2,2,3,4,12,29,A4,A12,C5
04_12_36,xcond_1,GRCm39,1211,2129,3448,1209,2126,3444,2,3,4,4,12,36,A4,A12,C12
04_12_37,xcond_1,GRCm39,447,616,987,446,615,985,1,1,2,4,12,37,A4,A12,D1
04_12_56,xcond_1,GRCm39,1135,1780,3022,1134,1779,3018,1,1,4,4,12,56,A4,A12,E8
04_12_59,xcond_1,GRCm39,325,457,722,324,456,721,1,1,1,4,12,59,A4,A12,E11
04_12_69,xcond_1,GRCm39,257,332,492,256,331,490,1,1,2,4,12,69,A4,A12,F9
04_12_79,xcond_1,GRCm39,415,662,1135,415,662,1135,0,0,0,4,12,79,A4,A12,G7
04_13_24,xcond_1,GRCm39,374,542,863,374,542,863,0,0,0,4,13,24,A4,B1,B12
04_13_36,xcond_1,GRCm39,325,395,644,322,392,638,3,3,6,4,13,36,A4,B1,C12
04_13_66,xcond_1,GRCm39,1787,3249,5312,1784,3244,5304,3,5,8,4,13,66,A4,B1,F6
04_13_88,xcond_1,GRCm39,397,536,969,397,536,969,0,0,0,4,13,88,A4,B1,H4
04_14_07,xcond_1,GRCm39,190,231,349,190,231,349,0,0,0,4,14,7,A4,B2,A7
04_14_35,xcond_1,GRCm39,771,1156,1866,770,1155,1864,1,1,2,4,14,35,A4,B2,C11
04_14_41,xcond_1,GRCm39,714,1142,1882,713,1141,1881,1,1,1,4,14,41,A4,B2,D5
04_14_60,xcond_1,GRCm39,115,244,414,115,244,414,0,0,0,4,14,60,A4,B2,E12
04_15_43,xcond_1,GRCm39,445,595,1039,445,595,1039,0,0,0,4,15,43,A4,B3,D7
04_15_50,xcond_1,GRCm39,564,765,1313,564,765,1313,0,0,0,4,15,50,A4,B3,E2
04_15_51,xcond_1,GRCm39,1091,1824,2961,1089,1822,2959,2,2,2,4,15,51,A4,B3,E3
04_15_72,xcond_1,GRCm39,2461,5097,8590,2460,5095,8585,1,2,5,4,15,72,A4,B3,F12
04_15_96,xcond_1,GRCm39,193,229,376,193,229,376,0,0,0,4,15,96,A4,B3,H12
04_16_40,xcond_1,GRCm39,620,837,1371,620,837,1371,0,0,0,4,16,40,A4,B4,D4
04_16_51,xcond_1,GRCm39,1117,1707,2909,1115,1705,2907,2,2,2,4,16,51,A4,B4,E3
04_16_64,xcond_1,GRCm39,197,242,339,196,241,336,1,1,3,4,16,64,A4,B4,F4
04_16_81,xcond_1,GRCm39,201,240,421,200,239,420,1,1,1,4,16,81,A4,B4,G9
04_16_88,xcond_1,GRCm39,914,1418,2372,913,1417,2369,1,1,3,4,16,88,A4,B4,H4
04_17_01,xcond_1,GRCm39,658,1041,1739,657,1040,1738,1,1,1,4,17,1,A4,B5,A1
04_17_28,xcond_1,GRCm39,1128,1686,2802,1125,1683,2795,3,3,7,4,17,28,A4,B5,C4
04_17_57,xcond_1,GRCm39,236,287,458,235,286,456,1,1,2,4,17,57,A4,B5,E9
04_17_62,xcond_1,GRCm39,1484,2501,4179,1481,2498,4175,3,3,4,4,17,62,A4,B5,F2
04_18_32,xcond_1,GRCm39,1764,3096,5059,1761,3091,5047,3,5,12,4,18,32,A4,B6,C8
04_18_55,xcond_1,GRCm39,429,586,936,428,585,934,1,1,2,4,18,55,A4,B6,E7
04_18_66,xcond_1,GRCm39,1244,2075,3454,1242,2073,3448,2,2,6,4,18,66,A4,B6,F6
04_19_28,xcond_1,GRCm39,520,661,1092,520,661,1092,0,0,0,4,19,28,A4,B7,C4
04_20_36,xcond_1,GRCm39,603,967,1570,602,966,1568,1,1,2,4,20,36,A4,B8,C12
04_20_95,xcond_1,GRCm39,663,1010,1679,663,1010,1679,0,0,0,4,20,95,A4,B8,H11
04_21_73,xcond_1,GRCm39,600,836,1356,600,836,1356,0,0,0,4,21,73,A4,B9,G1
04_22_12,xcond_1,GRCm39,420,553,943,420,553,943,0,0,0,4,22,12,A4,B10,A12
04_22_55,xcond_1,GRCm39,510,711,1155,510,711,1155,0,0,0,4,22,55,A4,B10,E7
04_22_65,xcond_1,GRCm39,744,1099,1861,743,1097,1859,1,2,2,4,22,65,A4,B10,F5
04_22_90,xcond_1,GRCm39,570,870,1412,569,869,1411,1,1,1,4,22,90,A4,B10,H6
04_22_93,xcond_1,GRCm39,663,891,1467,663,891,1467,0,0,0,4,22,93,A4,B10,H9
04_24_14,xcond_1,GRCm39,273,341,561,273,341,561,0,0,0,4,24,14,A4,B12,B2
04_24_20,xcond_1,GRCm39,1004,1453,2393,1003,1452,2392,1,1,1,4,24,20,A4,B12,B8
04_24_45,xcond_1,GRCm39,522,720,1176,521,719,1175,1,1,1,4,24,45,A4,B12,D9
04_24_49,xcond_1,GRCm39,414,527,910,413,526,909,1,1,1,4,24,49,A4,B12,E1
04_24_65,xcond_1,GRCm39,421,588,992,419,586,990,2,2,2,4,24,65,A4,B12,F5
04_25_86,xcond_1,GRCm39,406,629,1067,405,628,1065,1,1,2,4,25,86,A4,C1,H2
04_26_31,xcond_1,GRCm39,1221,1864,3014,1219,1862,3011,2,2,3,4,26,31,A4,C2,C7
04_27_04,xcond_1,GRCm39,405,516,857,404,514,854,1,2,3,4,27,4,A4,C3,A4
04_27_14,xcond_1,GRCm39,618,829,1354,617,828,1353,1,1,1,4,27,14,A4,C3,B2
04_27_43,xcond_1,GRCm39,443,670,1065,443,670,1065,0,0,0,4,27,43,A4,C3,D7
04_27_48,xcond_1,GRCm39,1001,1669,2755,1001,1669,2755,0,0,0,4,27,48,A4,C3,D12
04_27_49,xcond_1,GRCm39,716,1087,1766,715,1084,1761,1,3,5,4,27,49,A4,C3,E1
04_27_67,xcond_1,GRCm39,262,329,541,262,329,541,0,0,0,4,27,67,A4,C3,F7
04_27_74,xcond_1,GRCm39,445,581,981,445,581,981,0,0,0,4,27,74,A4,C3,G2
04_27_83,xcond_1,GRCm39,368,462,730,367,461,729,1,1,1,4,27,83,A4,C3,G11
04_27_96,xcond_1,GRCm39,280,384,638,280,384,638,0,0,0,4,27,96,A4,C3,H12
04_28_24,xcond_1,GRCm39,433,568,905,432,567,904,1,1,1,4,28,24,A4,C4,B12
04_28_59,xcond_1,GRCm39,3699,9857,16099,3696,9853,16093,3,4,6,4,28,59,A4,C4,E11
04_28_79,xcond_1,GRCm39,761,1207,2037,759,1205,2033,2,2,4,4,28,79,A4,C4,G7
04_28_84,xcond_1,GRCm39,1524,2621,4392,1521,2618,4389,3,3,3,4,28,84,A4,C4,G12
04_29_21,xcond_1,GRCm39,714,1000,1695,714,1000,1695,0,0,0,4,29,21,A4,C5,B9
04_29_72,xcond_1,GRCm39,395,505,858,394,504,856,1,1,2,4,29,72,A4,C5,F12
04_29_78,xcond_1,GRCm39,258,323,538,258,323,538,0,0,0,4,29,78,A4,C5,G6
04_29_96,xcond_1,GRCm39,304,382,668,302,380,666,2,2,2,4,29,96,A4,C5,H12
04_30_16,xcond_1,GRCm39,283,350,557,283,350,557,0,0,0,4,30,16,A4,C6,B4
04_30_55,xcond_1,GRCm39,249,329,541,249,329,541,0,0,0,4,30,55,A4,C6,E7
04_30_91,xcond_1,GRCm39,793,1072,1798,793,1072,1798,0,0,0,4,30,91,A4,C6,H7
04_31_39,xcond_1,GRCm39,715,1051,1714,715,1051,1714,0,0,0,4,31,39,A4,C7,D3
04_31_68,xcond_1,GRCm39,274,335,581,274,335,581,0,0,0,4,31,68,A4,C7,F8
04_31_76,xcond_1,GRCm39,332,426,685,332,426,685,0,0,0,4,31,76,A4,C7,G4
04_31_77,xcond_1,GRCm39,391,490,815,391,490,815,0,0,0,4,31,77,A4,C7,G5
04_32_01,xcond_1,GRCm39,1903,4080,6710,1901,4078,6705,2,2,5,4,32,1,A4,C8,A1
04_32_12,xcond_1,GRCm39,740,1012,1634,740,1012,1634,0,0,0,4,32,12,A4,C8,A12
04_32_29,xcond_1,GRCm39,216,259,385,216,259,385,0,0,0,4,32,29,A4,C8,C5
04_32_30,xcond_1,GRCm39,598,817,1323,598,817,1323,0,0,0,4,32,30,A4,C8,C6
04_32_35,xcond_1,GRCm39,602,978,1592,602,978,1592,0,0,0,4,32,35,A4,C8,C11
04_32_39,xcond_1,GRCm39,520,743,1151,518,741,1149,2,2,2,4,32,39,A4,C8,D3
04_32_44,xcond_1,GRCm39,770,1183,1898,769,1181,1893,1,2,5,4,32,44,A4,C8,D8
04_32_48,xcond_1,GRCm39,182,217,288,182,217,288,0,0,0,4,32,48,A4,C8,D12
04_32_66,xcond_1,GRCm39,413,589,961,413,589,961,0,0,0,4,32,66,A4,C8,F6
04_32_84,xcond_1,GRCm39,6999,32274,54319,6987,32244,54276,12,30,43,4,32,84,A4,C8,G12
04_33_03,xcond_1,GRCm39,1030,1695,2776,1029,1693,2774,1,2,2,4,33,3,A4,C9,A3
04_33_11,xcond_1,GRCm39,1512,2650,4227,1510,2648,4224,2,2,3,4,33,11,A4,C9,A11
04_33_17,xcond_1,GRCm39,40,252,376,40,252,376,0,0,0,4,33,17,A4,C9,B5
04_33_37,xcond_1,GRCm39,516,784,1231,515,783,1230,1,1,1,4,33,37,A4,C9,D1
04_33_83,xcond_1,GRCm39,2596,5169,8547,2592,5163,8540,4,6,7,4,33,83,A4,C9,G11
04_34_37,xcond_1,GRCm39,484,691,1109,483,690,1108,1,1,1,4,34,37,A4,C10,D1
04_34_41,xcond_1,GRCm39,540,974,1537,539,973,1536,1,1,1,4,34,41,A4,C10,D5
04_34_53,xcond_1,GRCm39,294,423,733,293,421,731,1,2,2,4,34,53,A4,C10,E5
04_35_20,xcond_1,GRCm39,1498,2697,4353,1497,2696,4352,1,1,1,4,35,20,A4,C11,B8
04_35_38,xcond_1,GRCm39,747,1110,1776,747,1110,1776,0,0,0,4,35,38,A4,C11,D2
04_35_60,xcond_1,GRCm39,3944,10162,16488,3942,10158,16484,2,4,4,4,35,60,A4,C11,E12
04_36_09,xcond_1,GRCm39,436,617,1006,435,615,1004,1,2,2,4,36,9,A4,C12,A9
04_36_20,xcond_1,GRCm39,802,1240,1966,802,1240,1966,0,0,0,4,36,20,A4,C12,B8
04_36_52,xcond_1,GRCm39,286,355,496,285,354,495,1,1,1,4,36,52,A4,C12,E4
04_36_72,xcond_1,GRCm39,509,751,1218,506,748,1215,3,3,3,4,36,72,A4,C12,F12
04_37_42,xcond_1,GRCm39,318,439,702,317,438,701,1,1,1,4,37,42,A4,D1,D6
04_37_57,xcond_1,GRCm39,662,918,1560,662,918,1560,0,0,0,4,37,57,A4,D1,E9
04_37_61,xcond_1,GRCm39,269,320,544,269,320,544,0,0,0,4,37,61,A4,D1,F1
04_37_74,xcond_1,GRCm39,672,967,1631,670,965,1629,2,2,2,4,37,74,A4,D1,G2
04_37_90,xcond_1,GRCm39,602,803,1345,601,801,1340,1,2,5,4,37,90,A4,D1,H6
04_38_02,xcond_1,GRCm39,388,526,901,387,525,900,1,1,1,4,38,2,A4,D2,A2
04_38_32,xcond_1,GRCm39,1853,3513,5997,1853,3513,5997,0,0,0,4,38,32,A4,D2,C8
04_39_20,xcond_1,GRCm39,417,590,969,417,590,969,0,0,0,4,39,20,A4,D3,B8
04_39_85,xcond_1,GRCm39,309,384,612,309,384,612,0,0,0,4,39,85,A4,D3,H1
04_40_35,xcond_1,GRCm39,675,1048,1787,673,1045,1776,2,3,11,4,40,35,A4,D4,C11
04_40_38,xcond_1,GRCm39,973,1401,2409,973,1401,2409,0,0,0,4,40,38,A4,D4,D2
04_40_64,xcond_1,GRCm39,371,507,869,371,507,869,0,0,0,4,40,64,A4,D4,F4
04_40_67,xcond_1,GRCm39,952,1362,2284,952,1362,2284,0,0,0,4,40,67,A4,D4,F7
04_40_80,xcond_1,GRCm39,617,1031,1719,617,1031,1719,0,0,0,4,40,80,A4,D4,G8
04_41_11,xcond_1,GRCm39,1286,1999,3362,1284,1996,3354,2,3,8,4,41,11,A4,D5,A11
04_41_21,xcond_1,GRCm39,273,378,629,273,378,629,0,0,0,4,41,21,A4,D5,B9
04_41_26,xcond_1,GRCm39,427,548,948,427,548,948,0,0,0,4,41,26,A4,D5,C2
04_42_11,xcond_1,GRCm39,942,1801,2951,939,1798,2946,3,3,5,4,42,11,A4,D6,A11
04_42_59,xcond_1,GRCm39,585,770,1281,585,770,1281,0,0,0,4,42,59,A4,D6,E11
04_43_16,xcond_1,GRCm39,546,901,1450,545,900,1449,1,1,1,4,43,16,A4,D7,B4
04_44_12,xcond_1,GRCm39,325,443,699,325,443,699,0,0,0,4,44,12,A4,D8,A12
04_44_42,xcond_1,GRCm39,2070,3995,6617,2067,3992,6613,3,3,4,4,44,42,A4,D8,D6
04_44_50,xcond_1,GRCm39,328,464,741,328,464,741,0,0,0,4,44,50,A4,D8,E2
04_44_59,xcond_1,GRCm39,463,596,1008,463,596,1008,0,0,0,4,44,59,A4,D8,E11
04_44_72,xcond_1,GRCm39,465,628,981,465,628,981,0,0,0,4,44,72,A4,D8,F12
04_44_87,xcond_1,GRCm39,510,704,1136,510,704,1136,0,0,0,4,44,87,A4,D8,H3
04_45_15,xcond_1,GRCm39,456,683,1115,455,682,1114,1,1,1,4,45,15,A4,D9,B3
04_45_20,xcond_1,GRCm39,349,458,758,349,458,758,0,0,0,4,45,20,A4,D9,B8
04_45_35,xcond_1,GRCm39,588,910,1458,588,910,1458,0,0,0,4,45,35,A4,D9,C11
04_45_63,xcond_1,GRCm39,302,413,683,302,413,683,0,0,0,4,45,63,A4,D9,F3
04_45_84,xcond_1,GRCm39,491,673,1159,489,671,1157,2,2,2,4,45,84,A4,D9,G12
04_46_30,xcond_1,GRCm39,576,818,1370,574,816,1367,2,2,3,4,46,30,A4,D10,C6
04_46_33,xcond_1,GRCm39,242,280,441,242,280,441,0,0,0,4,46,33,A4,D10,C9
04_46_39,xcond_1,GRCm39,835,1216,1976,832,1213,1969,3,3,7,4,46,39,A4,D10,D3
04_46_66,xcond_1,GRCm39,740,1275,2073,739,1273,2069,1,2,4,4,46,66,A4,D10,F6
04_46_88,xcond_1,GRCm39,807,1253,2107,807,1253,2107,0,0,0,4,46,88,A4,D10,H4
04_46_93,xcond_1,GRCm39,362,505,824,360,502,815,2,3,9,4,46,93,A4,D10,H9
04_47_16,xcond_1,GRCm39,536,765,1266,536,765,1266,0,0,0,4,47,16,A4,D11,B4
04_47_31,xcond_1,GRCm39,358,445,693,357,444,692,1,1,1,4,47,31,A4,D11,C7
04_47_41,xcond_1,GRCm39,1034,1613,2667,1032,1611,2665,2,2,2,4,47,41,A4,D11,D5
04_48_12,xcond_1,GRCm39,333,427,666,333,427,666,0,0,0,4,48,12,A4,D12,A12
04_48_44,xcond_1,GRCm39,293,365,603,293,365,603,0,0,0,4,48,44,A4,D12,D8
04_48_63,xcond_1,GRCm39,313,393,642,312,392,641,1,1,1,4,48,63,A4,D12,F3
04_49_35,xcond_1,GRCm39,1820,3124,5089,1818,3122,5087,2,2,2,4,49,35,A4,E1,C11
04_49_40,xcond_1,GRCm39,698,967,1596,696,964,1593,2,3,3,4,49,40,A4,E1,D4
04_49_61,xcond_1,GRCm39,584,814,1320,583,813,1317,1,1,3,4,49,61,A4,E1,F1
04_50_08,xcond_1,GRCm39,979,1596,2553,978,1595,2551,1,1,2,4,50,8,A4,E2,A8
04_50_43,xcond_1,GRCm39,1160,1920,3170,1159,1919,3166,1,1,4,4,50,43,A4,E2,D7
04_50_69,xcond_1,GRCm39,211,253,422,210,252,418,1,1,4,4,50,69,A4,E2,F9
04_50_71,xcond_1,GRCm39,453,608,1011,452,607,1010,1,1,1,4,50,71,A4,E2,F11
04_51_15,xcond_1,GRCm39,1287,2119,3574,1286,2117,3571,1,2,3,4,51,15,A4,E3,B3
04_51_30,xcond_1,GRCm39,536,718,1180,534,716,1177,2,2,3,4,51,30,A4,E3,C6
04_51_60,xcond_1,GRCm39,929,1564,2603,927,1561,2600,2,3,3,4,51,60,A4,E3,E12
04_51_61,xcond_1,GRCm39,606,825,1332,604,823,1330,2,2,2,4,51,61,A4,E3,F1
04_52_25,xcond_1,GRCm39,716,1199,1968,715,1198,1967,1,1,1,4,52,25,A4,E4,C1
04_52_35,xcond_1,GRCm39,878,1310,2194,877,1309,2192,1,1,2,4,52,35,A4,E4,C11
04_52_41,xcond_1,GRCm39,1469,2332,3697,1464,2326,3690,5,6,7,4,52,41,A4,E4,D5
04_52_62,xcond_1,GRCm39,4129,11301,18664,4126,11291,18646,3,10,18,4,52,62,A4,E4,F2
04_52_64,xcond_1,GRCm39,1014,1503,2508,1011,1500,2501,3,3,7,4,52,64,A4,E4,F4
04_52_76,xcond_1,GRCm39,999,1714,2699,998,1713,2698,1,1,1,4,52,76,A4,E4,G4
04_52_81,xcond_1,GRCm39,301,371,645,301,371,645,0,0,0,4,52,81,A4,E4,G9
04_52_83,xcond_1,GRCm39,300,374,562,300,374,562,0,0,0,4,52,83,A4,E4,G11
04_52_92,xcond_1,GRCm39,873,1360,2169,873,1360,2169,0,0,0,4,52,92,A4,E4,H8
04_53_45,xcond_1,GRCm39,701,971,1620,700,970,1618,1,1,2,4,53,45,A4,E5,D9
04_53_79,xcond_1,GRCm39,262,324,532,262,324,532,0,0,0,4,53,79,A4,E5,G7
04_53_90,xcond_1,GRCm39,812,1344,2267,811,1343,2266,1,1,1,4,53,90,A4,E5,H6
04_54_04,xcond_1,GRCm39,1650,3441,5809,1648,3434,5801,2,7,8,4,54,4,A4,E6,A4
04_54_21,xcond_1,GRCm39,315,437,711,314,436,707,1,1,4,4,54,21,A4,E6,B9
04_54_49,xcond_1,GRCm39,249,298,489,248,297,488,1,1,1,4,54,49,A4,E6,E1
04_54_75,xcond_1,GRCm39,447,546,902,447,546,902,0,0,0,4,54,75,A4,E6,G3
04_54_78,xcond_1,GRCm39,387,528,885,387,528,885,0,0,0,4,54,78,A4,E6,G6
04_54_84,xcond_1,GRCm39,868,1512,2443,867,1510,2441,1,2,2,4,54,84,A4,E6,G12
04_55_13,xcond_1,GRCm39,342,453,761,342,453,761,0,0,0,4,55,13,A4,E7,B1
04_55_61,xcond_1,GRCm39,192,218,338,192,218,338,0,0,0,4,55,61,A4,E7,F1
04_55_64,xcond_1,GRCm39,407,542,866,407,542,866,0,0,0,4,55,64,A4,E7,F4
04_57_12,xcond_1,GRCm39,569,782,1320,568,781,1319,1,1,1,4,57,12,A4,E9,A12
04_57_65,xcond_1,GRCm39,2346,4351,7437,2343,4345,7429,3,6,8,4,57,65,A4,E9,F5
04_58_16,xcond_1,GRCm39,1293,2186,3596,1292,2184,3592,1,2,4,4,58,16,A4,E10,B4
04_58_17,xcond_1,GRCm39,379,493,779,379,493,779,0,0,0,4,58,17,A4,E10,B5
04_58_59,xcond_1,GRCm39,601,823,1337,601,823,1337,0,0,0,4,58,59,A4,E10,E11
04_58_81,xcond_1,GRCm39,1325,2185,3705,1324,2182,3700,1,3,5,4,58,81,A4,E10,G9
04_58_84,xcond_1,GRCm39,567,797,1324,566,796,1323,1,1,1,4,58,84,A4,E10,G12
04_59_36,xcond_1,GRCm39,538,716,1108,538,716,1108,0,0,0,4,59,36,A4,E11,C12
04_59_48,xcond_1,GRCm39,427,637,1050,426,636,1048,1,1,2,4,59,48,A4,E11,D12
04_59_57,xcond_1,GRCm39,243,310,506,243,310,506,0,0,0,4,59,57,A4,E11,E9
04_59_74,xcond_1,GRCm39,1340,2172,3633,1340,2172,3633,0,0,0,4,59,74,A4,E11,G2
04_59_81,xcond_1,GRCm39,499,747,1201,498,746,1200,1,1,1,4,59,81,A4,E11,G9
04_59_93,xcond_1,GRCm39,184,228,387,184,228,387,0,0,0,4,59,93,A4,E11,H9
04_60_03,xcond_1,GRCm39,192,229,363,192,229,363,0,0,0,4,60,3,A4,E12,A3
04_60_15,xcond_1,GRCm39,572,854,1489,572,854,1489,0,0,0,4,60,15,A4,E12,B3
04_61_02,xcond_1,GRCm39,409,557,922,409,557,922,0,0,0,4,61,2,A4,F1,A2
04_61_08,xcond_1,GRCm39,484,641,1087,483,640,1085,1,1,2,4,61,8,A4,F1,A8
04_62_05,xcond_1,GRCm39,825,1323,2246,824,1322,2245,1,1,1,4,62,5,A4,F2,A5
04_62_08,xcond_1,GRCm39,353,458,780,353,458,780,0,0,0,4,62,8,A4,F2,A8
04_62_14,xcond_1,GRCm39,420,529,861,420,529,861,0,0,0,4,62,14,A4,F2,B2
04_62_36,xcond_1,GRCm39,261,348,576,258,345,569,3,3,7,4,62,36,A4,F2,C12
04_62_85,xcond_1,GRCm39,823,1218,1999,823,1218,1999,0,0,0,4,62,85,A4,F2,H1
04_63_20,xcond_1,GRCm39,320,399,708,320,399,708,0,0,0,4,63,20,A4,F3,B8
04_63_35,xcond_1,GRCm39,252,293,476,252,293,476,0,0,0,4,63,35,A4,F3,C11
04_63_63,xcond_1,GRCm39,762,1237,2036,761,1236,2035,1,1,1,4,63,63,A4,F3,F3
04_63_78,xcond_1,GRCm39,568,816,1310,568,816,1310,0,0,0,4,63,78,A4,F3,G6
04_64_09,xcond_1,GRCm39,161,218,362,161,218,362,0,0,0,4,64,9,A4,F4,A9
04_64_48,xcond_1,GRCm39,1401,2218,3719,1399,2214,3714,2,4,5,4,64,48,A4,F4,D12
04_64_50,xcond_1,GRCm39,476,655,1148,475,654,1146,1,1,2,4,64,50,A4,F4,E2
04_64_57,xcond_1,GRCm39,328,462,803,328,462,803,0,0,0,4,64,57,A4,F4,E9
04_64_92,xcond_1,GRCm39,458,641,1068,458,641,1068,0,0,0,4,64,92,A4,F4,H8
04_64_95,xcond_1,GRCm39,572,937,1540,572,937,1540,0,0,0,4,64,95,A4,F4,H11
04_65_55,xcond_1,GRCm39,214,241,405,214,241,405,0,0,0,4,65,55,A4,F5,E7
04_65_85,xcond_1,GRCm39,425,568,937,425,568,937,0,0,0,4,65,85,A4,F5,H1
04_66_66,xcond_1,GRCm39,783,1349,2279,783,1349,2279,0,0,0,4,66,66,A4,F6,F6
04_66_95,xcond_1,GRCm39,533,757,1308,533,757,1308,0,0,0,4,66,95,A4,F6,H11
04_67_13,xcond_1,GRCm39,226,271,437,225,270,436,1,1,1,4,67,13,A4,F7,B1
04_68_02,xcond_1,GRCm39,285,367,605,285,367,605,0,0,0,4,68,2,A4,F8,A2
04_68_33,xcond_1,GRCm39,227,282,447,227,282,447,0,0,0,4,68,33,A4,F8,C9
04_69_71,xcond_1,GRCm39,2016,4507,7160,2015,4506,7159,1,1,1,4,69,71,A4,F9,F11
04_69_90,xcond_1,GRCm39,977,1564,2554,977,1564,2554,0,0,0,4,69,90,A4,F9,H6
04_69_93,xcond_1,GRCm39,578,833,1351,578,833,1351,0,0,0,4,69,93,A4,F9,H9
04_70_48,xcond_1,GRCm39,463,595,978,463,595,978,0,0,0,4,70,48,A4,F10,D12
04_70_60,xcond_1,GRCm39,439,626,1097,438,625,1094,1,1,3,4,70,60,A4,F10,E12
04_70_69,xcond_1,GRCm39,164,207,330,163,206,329,1,1,1,4,70,69,A4,F10,F9
04_70_76,xcond_1,GRCm39,437,615,958,436,614,955,1,1,3,4,70,76,A4,F10,G4
04_71_09,xcond_1,GRCm39,262,366,630,261,365,627,1,1,3,4,71,9,A4,F11,A9
04_71_31,xcond_1,GRCm39,2462,5455,8914,2459,5452,8909,3,3,5,4,71,31,A4,F11,C7
04_71_43,xcond_1,GRCm39,489,648,1055,488,647,1054,1,1,1,4,71,43,A4,F11,D7
04_71_59,xcond_1,GRCm39,681,1017,1638,680,1016,1637,1,1,1,4,71,59,A4,F11,E11
04_71_93,xcond_1,GRCm39,283,365,644,283,365,644,0,0,0,4,71,93,A4,F11,H9
04_72_39,xcond_1,GRCm39,2094,4032,6585,2090,4024,6576,4,8,9,4,72,39,A4,F12,D3
04_73_17,xcond_1,GRCm39,921,1356,2271,919,1354,2269,2,2,2,4,73,17,A4,G1,B5
04_73_18,xcond_1,GRCm39,235,378,612,235,378,612,0,0,0,4,73,18,A4,G1,B6
04_73_45,xcond_1,GRCm39,239,305,503,239,305,503,0,0,0,4,73,45,A4,G1,D9
04_74_27,xcond_1,GRCm39,506,662,1060,504,660,1058,2,2,2,4,74,27,A4,G2,C3
04_75_01,xcond_1,GRCm39,499,692,1167,499,692,1167,0,0,0,4,75,1,A4,G3,A1
04_75_31,xcond_1,GRCm39,634,981,1592,633,980,1591,1,1,1,4,75,31,A4,G3,C7
04_75_33,xcond_1,GRCm39,242,301,492,242,301,492,0,0,0,4,75,33,A4,G3,C9
04_76_44,xcond_1,GRCm39,509,701,1141,507,699,1137,2,2,4,4,76,44,A4,G4,D8
04_76_50,xcond_1,GRCm39,395,532,950,395,532,950,0,0,0,4,76,50,A4,G4,E2
04_76_53,xcond_1,GRCm39,1177,2172,3573,1176,2170,3571,1,2,2,4,76,53,A4,G4,E5
04_77_45,xcond_1,GRCm39,255,299,442,255,299,442,0,0,0,4,77,45,A4,G5,D9
04_77_52,xcond_1,GRCm39,1728,3112,4938,1727,3111,4937,1,1,1,4,77,52,A4,G5,E4
04_77_63,xcond_1,GRCm39,289,385,626,288,383,623,1,2,3,4,77,63,A4,G5,F3
04_78_15,xcond_1,GRCm39,683,1219,2108,683,1219,2108,0,0,0,4,78,15,A4,G6,B3
04_78_48,xcond_1,GRCm39,910,1380,2249,910,1380,2249,0,0,0,4,78,48,A4,G6,D12
04_78_63,xcond_1,GRCm39,354,533,908,354,533,908,0,0,0,4,78,63,A4,G6,F3
04_78_69,xcond_1,GRCm39,423,554,917,423,554,917,0,0,0,4,78,69,A4,G6,F9
04_78_96,xcond_1,GRCm39,207,256,403,207,256,403,0,0,0,4,78,96,A4,G6,H12
04_79_03,xcond_1,GRCm39,324,433,737,323,432,736,1,1,1,4,79,3,A4,G7,A3
04_79_15,xcond_1,GRCm39,312,378,627,311,377,626,1,1,1,4,79,15,A4,G7,B3
04_79_50,xcond_1,GRCm39,518,873,1425,518,873,1425,0,0,0,4,79,50,A4,G7,E2
04_79_56,xcond_1,GRCm39,649,966,1589,647,964,1586,2,2,3,4,79,56,A4,G7,E8
04_79_81,xcond_1,GRCm39,503,656,1129,503,656,1129,0,0,0,4,79,81,A4,G7,G9
04_80_13,xcond_1,GRCm39,579,877,1435,578,875,1431,1,2,4,4,80,13,A4,G8,B1
04_80_35,xcond_1,GRCm39,321,403,630,321,403,630,0,0,0,4,80,35,A4,G8,C11
04_80_43,xcond_1,GRCm39,542,761,1243,542,761,1243,0,0,0,4,80,43,A4,G8,D7
04_80_48,xcond_1,GRCm39,275,343,544,275,343,544,0,0,0,4,80,48,A4,G8,D12
04_81_71,xcond_1,GRCm39,1557,2679,4360,1553,2674,4354,4,5,6,4,81,71,A4,G9,F11
04_81_91,xcond_1,GRCm39,441,607,1013,440,606,1012,1,1,1,4,81,91,A4,G9,H7
04_81_96,xcond_1,GRCm39,412,614,1030,411,612,1028,1,2,2,4,81,96,A4,G9,H12
04_82_37,xcond_1,GRCm39,290,363,587,290,363,587,0,0,0,4,82,37,A4,G10,D1
04_82_64,xcond_1,GRCm39,241,313,497,241,313,497,0,0,0,4,82,64,A4,G10,F4
04_82_65,xcond_1,GRCm39,1185,2040,3299,1183,2037,3296,2,3,3,4,82,65,A4,G10,F5
04_82_72,xcond_1,GRCm39,342,465,767,342,465,767,0,0,0,4,82,72,A4,G10,F12
04_82_95,xcond_1,GRCm39,1592,3343,5492,1589,3339,5488,3,4,4,4,82,95,A4,G10,H11
04_83_05,xcond_1,GRCm39,713,947,1546,713,947,1546,0,0,0,4,83,5,A4,G11,A5
04_83_21,xcond_1,GRCm39,316,423,693,315,422,692,1,1,1,4,83,21,A4,G11,B9
04_83_55,xcond_1,GRCm39,808,1191,2014,806,1189,2012,2,2,2,4,83,55,A4,G11,E7
04_85_06,xcond_1,GRCm39,573,769,1252,573,769,1252,0,0,0,4,85,6,A4,H1,A6
04_85_09,xcond_1,GRCm39,395,542,885,395,542,885,0,0,0,4,85,9,A4,H1,A9
04_85_50,xcond_1,GRCm39,429,596,996,428,595,995,1,1,1,4,85,50,A4,H1,E2
04_85_83,xcond_1,GRCm39,477,641,1060,477,641,1060,0,0,0,4,85,83,A4,H1,G11
04_86_48,xcond_1,GRCm39,393,496,785,393,496,785,0,0,0,4,86,48,A4,H2,D12
04_86_53,xcond_1,GRCm39,573,804,1340,573,804,1340,0,0,0,4,86,53,A4,H2,E5
04_86_74,xcond_1,GRCm39,564,822,1266,564,822,1266,0,0,0,4,86,74,A4,H2,G2
04_86_84,xcond_1,GRCm39,371,503,832,371,503,832,0,0,0,4,86,84,A4,H2,G12
04_87_09,xcond_1,GRCm39,797,1089,1718,795,1087,1716,2,2,2,4,87,9,A4,H3,A9
04_87_37,xcond_1,GRCm39,821,1288,2053,820,1287,2052,1,1,1,4,87,37,A4,H3,D1
04_87_77,xcond_1,GRCm39,535,805,1288,535,805,1288,0,0,0,4,87,77,A4,H3,G5
04_88_02,xcond_1,GRCm39,419,586,913,419,586,913,0,0,0,4,88,2,A4,H4,A2
04_88_27,xcond_1,GRCm39,360,477,753,360,477,753,0,0,0,4,88,27,A4,H4,C3
04_88_61,xcond_1,GRCm39,485,665,1056,485,665,1056,0,0,0,4,88,61,A4,H4,F1
04_88_65,xcond_1,GRCm39,1115,1830,2969,1114,1828,2967,1,2,2,4,88,65,A4,H4,F5
04_89_12,xcond_1,GRCm39,368,457,726,367,455,724,1,2,2,4,89,12,A4,H5,A12
04_89_27,xcond_1,GRCm39,346,445,679,346,445,679,0,0,0,4,89,27,A4,H5,C3
04_89_60,xcond_1,GRCm39,283,358,585,283,358,585,0,0,0,4,89,60,A4,H5,E12
04_89_66,xcond_1,GRCm39,341,430,704,339,428,697,2,2,7,4,89,66,A4,H5,F6
04_89_74,xcond_1,GRCm39,243,278,452,243,278,452,0,0,0,4,89,74,A4,H5,G2
04_89_95,xcond_1,GRCm39,1049,1656,2739,1048,1655,2738,1,1,1,4,89,95,A4,H5,H11
04_90_26,xcond_1,GRCm39,418,561,938,418,561,938,0,0,0,4,90,26,A4,H6,C2
04_91_06,xcond_1,GRCm39,631,951,1532,631,951,1532,0,0,0,4,91,6,A4,H7,A6
04_91_69,xcond_1,GRCm39,762,1277,2051,761,1276,2049,1,1,2,4,91,69,A4,H7,F9
04_91_90,xcond_1,GRCm39,296,340,522,295,338,514,1,2,8,4,91,90,A4,H7,H6
04_91_91,xcond_1,GRCm39,603,805,1293,602,804,1292,1,1,1,4,91,91,A4,H7,H7
04_92_05,xcond_1,GRCm39,547,770,1301,546,768,1297,1,2,4,4,92,5,A4,H8,A5
04_92_20,xcond_1,GRCm39,366,500,794,366,500,794,0,0,0,4,92,20,A4,H8,B8
04_93_11,xcond_1,GRCm39,472,707,1149,471,706,1148,1,1,1,4,93,11,A4,H9,A11
04_93_39,xcond_1,GRCm39,1623,2774,4580,1618,2766,4567,5,8,13,4,93,39,A4,H9,D3
04_93_84,xcond_1,GRCm39,837,1272,2109,836,1271,2108,1,1,1,4,93,84,A4,H9,G12
04_94_20,xcond_1,GRCm39,540,885,1542,540,885,1542,0,0,0,4,94,20,A4,H10,B8
04_94_84,xcond_1,GRCm39,821,1250,2125,820,1249,2124,1,1,1,4,94,84,A4,H10,G12
04_94_88,xcond_1,GRCm39,1148,1775,2944,1146,1772,2941,2,3,3,4,94,88,A4,H10,H4
04_95_02,xcond_1,GRCm39,361,454,746,361,454,746,0,0,0,4,95,2,A4,H11,A2
04_95_49,xcond_1,GRCm39,302,376,609,301,375,608,1,1,1,4,95,49,A4,H11,E1
04_95_59,xcond_1,GRCm39,482,670,1097,481,669,1096,1,1,1,4,95,59,A4,H11,E11
04_95_84,xcond_1,GRCm39,330,429,737,330,429,737,0,0,0,4,95,84,A4,H11,G12
05_01_33,xcond_1,GRCm39,501,750,1228,501,750,1228,0,0,0,5,1,33,A5,A1,C9
05_02_32,xcond_1,GRCm39,274,332,550,273,331,549,1,1,1,5,2,32,A5,A2,C8
05_02_56,xcond_1,GRCm39,847,1393,2343,843,1388,2335,4,5,8,5,2,56,A5,A2,E8
05_02_96,xcond_1,GRCm39,562,832,1345,561,831,1343,1,1,2,5,2,96,A5,A2,H12
05_03_26,xcond_1,GRCm39,441,600,976,441,600,976,0,0,0,5,3,26,A5,A3,C2
05_03_29,xcond_1,GRCm39,683,984,1600,683,984,1600,0,0,0,5,3,29,A5,A3,C5
05_03_37,xcond_1,GRCm39,1339,2619,4220,1339,2619,4220,0,0,0,5,3,37,A5,A3,D1
05_03_66,xcond_1,GRCm39,298,397,613,298,397,613,0,0,0,5,3,66,A5,A3,F6
05_03_69,xcond_1,GRCm39,465,608,947,465,608,947,0,0,0,5,3,69,A5,A3,F9
05_03_74,xcond_1,GRCm39,3632,10113,16484,3629,10109,16479,3,4,5,5,3,74,A5,A3,G2
05_04_91,xcond_1,GRCm39,439,634,1037,437,632,1033,2,2,4,5,4,91,A5,A4,H7
05_05_21,xcond_1,GRCm39,715,1092,1785,715,1092,1785,0,0,0,5,5,21,A5,A5,B9
05_05_43,xcond_1,GRCm39,729,1124,1812,728,1122,1808,1,2,4,5,5,43,A5,A5,D7
05_05_68,xcond_1,GRCm39,214,255,437,214,255,437,0,0,0,5,5,68,A5,A5,F8
05_06_04,xcond_1,GRCm39,311,395,686,311,395,686,0,0,0,5,6,4,A5,A6,A4
05_06_61,xcond_1,GRCm39,514,700,1171,514,700,1171,0,0,0,5,6,61,A5,A6,F1
05_07_27,xcond_1,GRCm39,5114,17945,28572,5109,17933,28555,5,12,17,5,7,27,A5,A7,C3
05_07_36,xcond_1,GRCm39,235,441,668,235,441,668,0,0,0,5,7,36,A5,A7,C12
05_07_44,xcond_1,GRCm39,843,1353,2229,843,1353,2229,0,0,0,5,7,44,A5,A7,D8
05_07_50,xcond_1,GRCm39,2377,5537,9168,2374,5533,9164,3,4,4,5,7,50,A5,A7,E2
05_07_63,xcond_1,GRCm39,1135,1776,2839,1135,1776,2839,0,0,0,5,7,63,A5,A7,F3
05_07_65,xcond_1,GRCm39,2371,5462,8809,2367,5457,8803,4,5,6,5,7,65,A5,A7,F5
05_07_78,xcond_1,GRCm39,2318,4450,7222,2316,4446,7213,2,4,9,5,7,78,A5,A7,G6
05_07_93,xcond_1,GRCm39,362,534,832,361,533,827,1,1,5,5,7,93,A5,A7,H9
05_08_41,xcond_1,GRCm39,479,704,1103,477,702,1099,2,2,4,5,8,41,A5,A8,D5
05_08_47,xcond_1,GRCm39,793,1150,1892,791,1148,1888,2,2,4,5,8,47,A5,A8,D11
05_09_03,xcond_1,GRCm39,596,779,1291,596,779,1291,0,0,0,5,9,3,A5,A9,A3
05_09_16,xcond_1,GRCm39,1498,3022,4829,1497,3021,4828,1,1,1,5,9,16,A5,A9,B4
05_09_36,xcond_1,GRCm39,638,944,1537,635,941,1534,3,3,3,5,9,36,A5,A9,C12
05_09_40,xcond_1,GRCm39,759,1371,2262,758,1369,2260,1,2,2,5,9,40,A5,A9,D4
05_09_50,xcond_1,GRCm39,211,252,411,211,252,411,0,0,0,5,9,50,A5,A9,E2
05_10_02,xcond_1,GRCm39,3421,8671,14077,3417,8661,14055,4,10,22,5,10,2,A5,A10,A2
05_10_03,xcond_1,GRCm39,949,2058,3195,947,2056,3193,2,2,2,5,10,3,A5,A10,A3
05_10_33,xcond_1,GRCm39,683,1016,1605,682,1015,1604,1,1,1,5,10,33,A5,A10,C9
05_10_72,xcond_1,GRCm39,774,1440,2348,772,1438,2346,2,2,2,5,10,72,A5,A10,F12
05_10_74,xcond_1,GRCm39,512,731,1188,512,731,1188,0,0,0,5,10,74,A5,A10,G2
05_10_83,xcond_1,GRCm39,370,500,788,370,500,788,0,0,0,5,10,83,A5,A10,G11
05_11_90,xcond_1,GRCm39,760,1112,1748,758,1110,1746,2,2,2,5,11,90,A5,A11,H6
05_11_95,xcond_1,GRCm39,734,1206,1902,732,1204,1899,2,2,3,5,11,95,A5,A11,H11
05_12_25,xcond_1,GRCm39,1523,3309,5307,1520,3305,5303,3,4,4,5,12,25,A5,A12,C1
05_12_77,xcond_1,GRCm39,122,226,357,122,226,357,0,0,0,5,12,77,A5,A12,G5
05_12_85,xcond_1,GRCm39,598,855,1416,598,855,1416,0,0,0,5,12,85,A5,A12,H1
05_12_88,xcond_1,GRCm39,925,1471,2507,924,1470,2506,1,1,1,5,12,88,A5,A12,H4
05_13_08,xcond_1,GRCm39,1327,2038,3350,1327,2038,3350,0,0,0,5,13,8,A5,B1,A8
05_13_49,xcond_1,GRCm39,709,1048,1696,709,1048,1696,0,0,0,5,13,49,A5,B1,E1
05_14_02,xcond_1,GRCm39,1549,2584,4300,1547,2581,4294,2,3,6,5,14,2,A5,B2,A2
05_14_08,xcond_1,GRCm39,1379,2470,4005,1377,2468,4001,2,2,4,5,14,8,A5,B2,A8
05_14_24,xcond_1,GRCm39,1136,1729,2829,1136,1729,2829,0,0,0,5,14,24,A5,B2,B12
05_14_53,xcond_1,GRCm39,420,610,1005,420,610,1005,0,0,0,5,14,53,A5,B2,E5
05_14_72,xcond_1,GRCm39,75,622,924,74,621,923,1,1,1,5,14,72,A5,B2,F12
05_14_75,xcond_1,GRCm39,196,230,375,196,230,375,0,0,0,5,14,75,A5,B2,G3
05_14_93,xcond_1,GRCm39,687,1139,1888,687,1139,1888,0,0,0,5,14,93,A5,B2,H9
05_15_04,xcond_1,GRCm39,993,1600,2598,990,1597,2595,3,3,3,5,15,4,A5,B3,A4
05_15_21,xcond_1,GRCm39,198,238,374,198,238,374,0,0,0,5,15,21,A5,B3,B9
05_15_56,xcond_1,GRCm39,946,1778,2842,943,1773,2835,3,5,7,5,15,56,A5,B3,E8
05_16_64,xcond_1,GRCm39,242,302,458,242,302,458,0,0,0,5,16,64,A5,B4,F4
05_17_25,xcond_1,GRCm39,1801,3516,5691,1798,3511,5685,3,5,6,5,17,25,A5,B5,C1
05_17_33,xcond_1,GRCm39,396,504,867,394,501,862,2,3,5,5,17,33,A5,B5,C9
05_17_54,xcond_1,GRCm39,793,1136,1958,792,1135,1955,1,1,3,5,17,54,A5,B5,E6
05_18_11,xcond_1,GRCm39,653,906,1470,652,904,1467,1,2,3,5,18,11,A5,B6,A11
05_18_27,xcond_1,GRCm39,1274,2328,3670,1271,2322,3658,3,6,12,5,18,27,A5,B6,C3
05_18_57,xcond_1,GRCm39,976,1711,2668,975,1710,2665,1,1,3,5,18,57,A5,B6,E9
05_18_71,xcond_1,GRCm39,800,1179,1889,798,1177,1885,2,2,4,5,18,71,A5,B6,F11
05_19_54,xcond_1,GRCm39,479,646,1034,478,644,1032,1,2,2,5,19,54,A5,B7,E6
05_19_72,xcond_1,GRCm39,1361,2699,4483,1359,2696,4480,2,3,3,5,19,72,A5,B7,F12
05_20_24,xcond_1,GRCm39,1999,4412,7008,1996,4408,7001,3,4,7,5,20,24,A5,B8,B12
05_20_48,xcond_1,GRCm39,975,1647,2629,973,1645,2626,2,2,3,5,20,48,A5,B8,D12
05_20_52,xcond_1,GRCm39,1036,1729,2766,1034,1724,2758,2,5,8,5,20,52,A5,B8,E4
05_21_06,xcond_1,GRCm39,630,895,1423,629,894,1420,1,1,3,5,21,6,A5,B9,A6
05_21_43,xcond_1,GRCm39,425,560,935,424,559,934,1,1,1,5,21,43,A5,B9,D7
05_21_66,xcond_1,GRCm39,679,1587,2550,679,1587,2550,0,0,0,5,21,66,A5,B9,F6
05_21_88,xcond_1,GRCm39,414,896,1446,414,896,1446,0,0,0,5,21,88,A5,B9,H4
05_21_91,xcond_1,GRCm39,280,367,604,280,367,604,0,0,0,5,21,91,A5,B9,H7
05_21_96,xcond_1,GRCm39,1315,2227,3599,1315,2227,3599,0,0,0,5,21,96,A5,B9,H12
05_22_30,xcond_1,GRCm39,407,604,936,406,602,932,1,2,4,5,22,30,A5,B10,C6
05_22_33,xcond_1,GRCm39,1633,2741,4554,1633,2741,4554,0,0,0,5,22,33,A5,B10,C9
05_22_41,xcond_1,GRCm39,497,669,1101,497,669,1101,0,0,0,5,22,41,A5,B10,D5
05_22_61,xcond_1,GRCm39,3451,8401,13857,3447,8395,13847,4,6,10,5,22,61,A5,B10,F1
05_22_64,xcond_1,GRCm39,302,412,673,302,412,673,0,0,0,5,22,64,A5,B10,F4
05_23_83,xcond_1,GRCm39,588,903,1471,586,901,1466,2,2,5,5,23,83,A5,B11,G11
05_24_26,xcond_1,GRCm39,780,1235,2039,780,1235,2039,0,0,0,5,24,26,A5,B12,C2
05_24_29,xcond_1,GRCm39,855,1292,2120,854,1291,2119,1,1,1,5,24,29,A5,B12,C5
05_24_37,xcond_1,GRCm39,2205,4377,7289,2203,4374,7284,2,3,5,5,24,37,A5,B12,D1
05_24_38,xcond_1,GRCm39,294,354,543,294,354,543,0,0,0,5,24,38,A5,B12,D2
05_24_49,xcond_1,GRCm39,940,1483,2450,938,1481,2448,2,2,2,5,24,49,A5,B12,E1
05_24_55,xcond_1,GRCm39,1279,2560,4191,1277,2558,4189,2,2,2,5,24,55,A5,B12,E7
05_24_62,xcond_1,GRCm39,1489,2375,3840,1487,2372,3834,2,3,6,5,24,62,A5,B12,F2
05_24_77,xcond_1,GRCm39,1234,2481,3977,1233,2480,3976,1,1,1,5,24,77,A5,B12,G5
05_25_16,xcond_1,GRCm39,614,979,1645,614,979,1645,0,0,0,5,25,16,A5,C1,B4
05_25_21,xcond_1,GRCm39,338,429,705,338,429,705,0,0,0,5,25,21,A5,C1,B9
05_25_81,xcond_1,GRCm39,422,657,1109,422,657,1109,0,0,0,5,25,81,A5,C1,G9
05_25_96,xcond_1,GRCm39,796,1326,2189,796,1326,2189,0,0,0,5,25,96,A5,C1,H12
05_26_01,xcond_1,GRCm39,734,1120,1819,734,1120,1819,0,0,0,5,26,1,A5,C2,A1
05_26_49,xcond_1,GRCm39,1818,3531,5822,1815,3528,5816,3,3,6,5,26,49,A5,C2,E1
05_26_74,xcond_1,GRCm39,1846,4026,6491,1842,4019,6480,4,7,11,5,26,74,A5,C2,G2
05_26_84,xcond_1,GRCm39,742,1179,1956,741,1178,1955,1,1,1,5,26,84,A5,C2,G12
05_27_08,xcond_1,GRCm39,403,546,890,403,546,890,0,0,0,5,27,8,A5,C3,A8
05_27_36,xcond_1,GRCm39,864,1314,2175,864,1314,2175,0,0,0,5,27,36,A5,C3,C12
05_27_95,xcond_1,GRCm39,637,976,1608,637,976,1608,0,0,0,5,27,95,A5,C3,H11
05_28_18,xcond_1,GRCm39,611,806,1358,611,806,1358,0,0,0,5,28,18,A5,C4,B6
05_28_52,xcond_1,GRCm39,2532,5720,9256,2529,5711,9247,3,9,9,5,28,52,A5,C4,E4
05_28_64,xcond_1,GRCm39,795,1254,2091,793,1252,2088,2,2,3,5,28,64,A5,C4,F4
05_28_93,xcond_1,GRCm39,267,334,521,266,333,520,1,1,1,5,28,93,A5,C4,H9
05_29_36,xcond_1,GRCm39,205,244,360,205,244,360,0,0,0,5,29,36,A5,C5,C12
05_29_38,xcond_1,GRCm39,925,1551,2590,925,1551,2590,0,0,0,5,29,38,A5,C5,D2
05_29_48,xcond_1,GRCm39,766,1132,1831,764,1130,1827,2,2,4,5,29,48,A5,C5,D12
05_29_81,xcond_1,GRCm39,2641,5375,8916,2638,5372,8913,3,3,3,5,29,81,A5,C5,G9
05_29_85,xcond_1,GRCm39,588,980,1584,587,979,1582,1,1,2,5,29,85,A5,C5,H1
05_29_87,xcond_1,GRCm39,1730,3745,6012,1729,3742,6008,1,3,4,5,29,87,A5,C5,H3
05_30_07,xcond_1,GRCm39,531,780,1264,529,778,1262,2,2,2,5,30,7,A5,C6,A7
05_30_32,xcond_1,GRCm39,240,272,424,240,272,424,0,0,0,5,30,32,A5,C6,C8
05_30_35,xcond_1,GRCm39,953,1681,2615,953,1681,2615,0,0,0,5,30,35,A5,C6,C11
05_30_42,xcond_1,GRCm39,404,483,750,404,483,750,0,0,0,5,30,42,A5,C6,D6
05_30_59,xcond_1,GRCm39,204,249,387,204,249,387,0,0,0,5,30,59,A5,C6,E11
05_31_47,xcond_1,GRCm39,838,1424,2366,836,1421,2361,2,3,5,5,31,47,A5,C7,D11
05_31_79,xcond_1,GRCm39,761,1391,2306,760,1390,2304,1,1,2,5,31,79,A5,C7,G7
05_31_84,xcond_1,GRCm39,2345,5698,9141,2340,5693,9133,5,5,8,5,31,84,A5,C7,G12
05_32_12,xcond_1,GRCm39,142,205,316,141,204,315,1,1,1,5,32,12,A5,C8,A12
05_32_20,xcond_1,GRCm39,2645,5686,9365,2642,5683,9359,3,3,6,5,32,20,A5,C8,B8
05_32_48,xcond_1,GRCm39,4856,16038,25905,4849,16020,25879,7,18,26,5,32,48,A5,C8,D12
05_32_63,xcond_1,GRCm39,896,1451,2393,893,1448,2389,3,3,4,5,32,63,A5,C8,F3
05_32_84,xcond_1,GRCm39,355,444,652,355,444,652,0,0,0,5,32,84,A5,C8,G12
05_32_95,xcond_1,GRCm39,546,785,1245,546,785,1245,0,0,0,5,32,95,A5,C8,H11
05_33_24,xcond_1,GRCm39,1360,2304,3813,1358,2302,3806,2,2,7,5,33,24,A5,C9,B12
05_34_48,xcond_1,GRCm39,438,678,1121,438,678,1121,0,0,0,5,34,48,A5,C10,D12
05_34_56,xcond_1,GRCm39,1416,2797,4497,1415,2796,4496,1,1,1,5,34,56,A5,C10,E8
05_34_86,xcond_1,GRCm39,1098,2397,3982,1098,2397,3982,0,0,0,5,34,86,A5,C10,H2
05_34_87,xcond_1,GRCm39,1936,4235,6785,1934,4233,6783,2,2,2,5,34,87,A5,C10,H3
05_34_95,xcond_1,GRCm39,708,2844,4582,707,2843,4581,1,1,1,5,34,95,A5,C10,H11
05_35_04,xcond_1,GRCm39,569,811,1302,569,811,1302,0,0,0,5,35,4,A5,C11,A4
05_36_52,xcond_1,GRCm39,367,512,721,366,511,720,1,1,1,5,36,52,A5,C12,E4
05_36_57,xcond_1,GRCm39,2093,4855,7841,2089,4851,7836,4,4,5,5,36,57,A5,C12,E9
05_36_68,xcond_1,GRCm39,124,233,370,124,233,370,0,0,0,5,36,68,A5,C12,F8
05_36_77,xcond_1,GRCm39,1055,1864,2967,1054,1863,2966,1,1,1,5,36,77,A5,C12,G5
05_36_80,xcond_1,GRCm39,831,1378,2146,830,1377,2145,1,1,1,5,36,80,A5,C12,G8
05_37_31,xcond_1,GRCm39,884,1219,2040,881,1216,2027,3,3,13,5,37,31,A5,D1,C7
05_37_38,xcond_1,GRCm39,468,697,1128,468,697,1128,0,0,0,5,37,38,A5,D1,D2
05_37_81,xcond_1,GRCm39,701,1090,1842,699,1085,1834,2,5,8,5,37,81,A5,D1,G9
05_38_16,xcond_1,GRCm39,449,655,1079,448,654,1078,1,1,1,5,38,16,A5,D2,B4
05_38_21,xcond_1,GRCm39,500,716,1171,500,716,1171,0,0,0,5,38,21,A5,D2,B9
05_38_55,xcond_1,GRCm39,1409,2578,4184,1408,2577,4183,1,1,1,5,38,55,A5,D2,E7
05_39_12,xcond_1,GRCm39,1278,2161,3411,1277,2160,3410,1,1,1,5,39,12,A5,D3,A12
05_39_42,xcond_1,GRCm39,1222,2321,3593,1220,2318,3589,2,3,4,5,39,42,A5,D3,D6
05_39_62,xcond_1,GRCm39,1379,2670,4265,1378,2668,4263,1,2,2,5,39,62,A5,D3,F2
05_40_24,xcond_1,GRCm39,757,1272,2147,756,1271,2144,1,1,3,5,40,24,A5,D4,B12
05_40_29,xcond_1,GRCm39,1054,1733,2841,1053,1731,2839,1,2,2,5,40,29,A5,D4,C5
05_40_52,xcond_1,GRCm39,419,522,819,419,522,819,0,0,0,5,40,52,A5,D4,E4
05_40_72,xcond_1,GRCm39,198,243,398,197,242,396,1,1,2,5,40,72,A5,D4,F12
05_40_76,xcond_1,GRCm39,370,506,849,370,506,849,0,0,0,5,40,76,A5,D4,G4
05_41_55,xcond_1,GRCm39,985,1726,2811,985,1726,2811,0,0,0,5,41,55,A5,D5,E7
05_41_74,xcond_1,GRCm39,292,414,698,292,414,698,0,0,0,5,41,74,A5,D5,G2
05_41_93,xcond_1,GRCm39,215,294,476,214,293,475,1,1,1,5,41,93,A5,D5,H9
05_42_09,xcond_1,GRCm39,257,318,523,257,318,523,0,0,0,5,42,9,A5,D6,A9
05_42_27,xcond_1,GRCm39,709,1186,1809,709,1186,1809,0,0,0,5,42,27,A5,D6,C3
05_42_81,xcond_1,GRCm39,459,580,941,459,580,941,0,0,0,5,42,81,A5,D6,G9
05_43_09,xcond_1,GRCm39,505,826,1300,504,825,1299,1,1,1,5,43,9,A5,D7,A9
05_43_13,xcond_1,GRCm39,654,939,1547,654,939,1547,0,0,0,5,43,13,A5,D7,B1
05_43_37,xcond_1,GRCm39,639,1175,1835,638,1174,1834,1,1,1,5,43,37,A5,D7,D1
05_43_38,xcond_1,GRCm39,602,836,1366,602,836,1366,0,0,0,5,43,38,A5,D7,D2
05_43_52,xcond_1,GRCm39,463,615,981,462,614,977,1,1,4,5,43,52,A5,D7,E4
05_43_90,xcond_1,GRCm39,1087,1895,2996,1086,1892,2991,1,3,5,5,43,90,A5,D7,H6
05_44_09,xcond_1,GRCm39,176,220,365,176,220,365,0,0,0,5,44,9,A5,D8,A9
05_44_11,xcond_1,GRCm39,314,453,762,314,453,762,0,0,0,5,44,11,A5,D8,A11
05_44_24,xcond_1,GRCm39,424,709,1122,424,709,1122,0,0,0,5,44,24,A5,D8,B12
05_44_81,xcond_1,GRCm39,823,1191,1959,821,1189,1957,2,2,2,5,44,81,A5,D8,G9
05_45_45,xcond_1,GRCm39,933,1392,2285,932,1391,2284,1,1,1,5,45,45,A5,D9,D9
05_45_57,xcond_1,GRCm39,281,359,566,281,359,566,0,0,0,5,45,57,A5,D9,E9
05_45_76,xcond_1,GRCm39,1704,3516,5684,1701,3513,5680,3,3,4,5,45,76,A5,D9,G4
05_46_16,xcond_1,GRCm39,994,1903,3026,992,1901,3024,2,2,2,5,46,16,A5,D10,B4
05_46_93,xcond_1,GRCm39,396,494,802,395,493,799,1,1,3,5,46,93,A5,D10,H9
05_47_26,xcond_1,GRCm39,651,910,1504,650,909,1503,1,1,1,5,47,26,A5,D11,C2
05_47_31,xcond_1,GRCm39,2250,4773,7595,2247,4767,7588,3,6,7,5,47,31,A5,D11,C7
05_47_36,xcond_1,GRCm39,611,876,1444,610,875,1443,1,1,1,5,47,36,A5,D11,C12
05_48_56,xcond_1,GRCm39,2728,6043,9761,2725,6040,9757,3,3,4,5,48,56,A5,D12,E8
05_49_38,xcond_1,GRCm39,2426,5477,8886,2423,5472,8877,3,5,9,5,49,38,A5,E1,D2
05_49_54,xcond_1,GRCm39,367,455,752,367,455,752,0,0,0,5,49,54,A5,E1,E6
05_49_84,xcond_1,GRCm39,881,1412,2343,878,1409,2335,3,3,8,5,49,84,A5,E1,G12
05_49_92,xcond_1,GRCm39,631,957,1623,629,954,1619,2,3,4,5,49,92,A5,E1,H8
05_50_23,xcond_1,GRCm39,1703,3247,5408,1700,3243,5404,3,4,4,5,50,23,A5,E2,B11
05_50_33,xcond_1,GRCm39,263,322,516,263,322,516,0,0,0,5,50,33,A5,E2,C9
05_50_52,xcond_1,GRCm39,344,439,666,344,439,666,0,0,0,5,50,52,A5,E2,E4
05_50_57,xcond_1,GRCm39,871,1306,2141,870,1305,2140,1,1,1,5,50,57,A5,E2,E9
05_50_66,xcond_1,GRCm39,2422,4662,7647,2420,4660,7643,2,2,4,5,50,66,A5,E2,F6
05_51_30,xcond_1,GRCm39,421,545,867,420,544,866,1,1,1,5,51,30,A5,E3,C6
05_51_54,xcond_1,GRCm39,481,734,1210,481,734,1210,0,0,0,5,51,54,A5,E3,E6
05_51_75,xcond_1,GRCm39,796,1350,2240,792,1346,2232,4,4,8,5,51,75,A5,E3,G3
05_52_12,xcond_1,GRCm39,548,719,1136,546,717,1134,2,2,2,5,52,12,A5,E4,A12
05_52_53,xcond_1,GRCm39,216,261,402,216,261,402,0,0,0,5,52,53,A5,E4,E5
05_52_56,xcond_1,GRCm39,1032,1727,2770,1031,1726,2769,1,1,1,5,52,56,A5,E4,E8
05_52_66,xcond_1,GRCm39,1742,3615,5878,1737,3608,5865,5,7,13,5,52,66,A5,E4,F6
05_52_87,xcond_1,GRCm39,1304,2519,4026,1303,2517,4023,1,2,3,5,52,87,A5,E4,H3
05_53_19,xcond_1,GRCm39,908,1460,2355,906,1458,2353,2,2,2,5,53,19,A5,E5,B7
05_53_27,xcond_1,GRCm39,1454,2564,4124,1452,2561,4116,2,3,8,5,53,27,A5,E5,C3
05_53_76,xcond_1,GRCm39,1279,2414,3926,1278,2413,3925,1,1,1,5,53,76,A5,E5,G4
05_53_90,xcond_1,GRCm39,793,1436,2351,790,1433,2348,3,3,3,5,53,90,A5,E5,H6
05_53_92,xcond_1,GRCm39,662,988,1673,661,986,1671,1,2,2,5,53,92,A5,E5,H8
05_54_09,xcond_1,GRCm39,1451,2487,4068,1447,2483,4062,4,4,6,5,54,9,A5,E6,A9
05_54_90,xcond_1,GRCm39,552,733,1220,552,733,1220,0,0,0,5,54,90,A5,E6,H6
05_55_07,xcond_1,GRCm39,987,1598,2644,987,1598,2644,0,0,0,5,55,7,A5,E7,A7
05_55_76,xcond_1,GRCm39,1523,2980,4805,1522,2979,4804,1,1,1,5,55,76,A5,E7,G4
05_56_23,xcond_1,GRCm39,1441,2708,4361,1436,2701,4353,5,7,8,5,56,23,A5,E8,B11
05_56_73,xcond_1,GRCm39,3358,9991,16178,3353,9981,16160,5,10,18,5,56,73,A5,E8,G1
05_56_87,xcond_1,GRCm39,808,1216,1996,807,1215,1995,1,1,1,5,56,87,A5,E8,H3
05_57_83,xcond_1,GRCm39,2226,4189,6915,2222,4182,6904,4,7,11,5,57,83,A5,E9,G11
05_58_16,xcond_1,GRCm39,5821,23489,38138,5811,23462,38102,10,27,36,5,58,16,A5,E10,B4
05_58_38,xcond_1,GRCm39,299,364,576,298,363,575,1,1,1,5,58,38,A5,E10,D2
05_58_41,xcond_1,GRCm39,1287,1986,3196,1286,1984,3193,1,2,3,5,58,41,A5,E10,D5
05_58_66,xcond_1,GRCm39,1035,1620,2570,1034,1619,2568,1,1,2,5,58,66,A5,E10,F6
05_59_28,xcond_1,GRCm39,401,555,898,401,555,898,0,0,0,5,59,28,A5,E11,C4
05_59_33,xcond_1,GRCm39,428,631,1026,428,631,1026,0,0,0,5,59,33,A5,E11,C9
05_59_64,xcond_1,GRCm39,1168,2396,3846,1164,2390,3839,4,6,7,5,59,64,A5,E11,F4
05_59_84,xcond_1,GRCm39,936,1393,2275,933,1390,2271,3,3,4,5,59,84,A5,E11,G12
05_60_08,xcond_1,GRCm39,1001,1567,2640,999,1565,2637,2,2,3,5,60,8,A5,E12,A8
05_61_33,xcond_1,GRCm39,347,458,737,345,456,734,2,2,3,5,61,33,A5,F1,C9
05_61_95,xcond_1,GRCm39,684,914,1490,683,913,1489,1,1,1,5,61,95,A5,F1,H11
05_62_23,xcond_1,GRCm39,594,796,1289,593,795,1287,1,1,2,5,62,23,A5,F2,B11
05_62_40,xcond_1,GRCm39,467,604,1053,466,603,1052,1,1,1,5,62,40,A5,F2,D4
05_63_07,xcond_1,GRCm39,1340,2616,4313,1338,2614,4311,2,2,2,5,63,7,A5,F3,A7
05_63_16,xcond_1,GRCm39,369,491,811,369,491,811,0,0,0,5,63,16,A5,F3,B4
05_63_18,xcond_1,GRCm39,757,1058,1739,756,1057,1738,1,1,1,5,63,18,A5,F3,B6
05_63_20,xcond_1,GRCm39,402,492,798,401,491,796,1,1,2,5,63,20,A5,F3,B8
05_63_47,xcond_1,GRCm39,1928,4460,7243,1923,4452,7233,5,8,10,5,63,47,A5,F3,D11
05_63_54,xcond_1,GRCm39,1592,2955,4911,1589,2951,4907,3,4,4,5,63,54,A5,F3,E6
05_63_56,xcond_1,GRCm39,1383,2462,4059,1382,2461,4058,1,1,1,5,63,56,A5,F3,E8
05_63_62,xcond_1,GRCm39,454,677,1099,454,677,1099,0,0,0,5,63,62,A5,F3,F2
05_63_64,xcond_1,GRCm39,2156,3967,6497,2152,3962,6490,4,5,7,5,63,64,A5,F3,F4
05_64_07,xcond_1,GRCm39,163,220,384,162,219,381,1,1,3,5,64,7,A5,F4,A7
05_64_14,xcond_1,GRCm39,525,792,1346,525,792,1346,0,0,0,5,64,14,A5,F4,B2
05_64_17,xcond_1,GRCm39,341,480,766,340,479,765,1,1,1,5,64,17,A5,F4,B5
05_64_32,xcond_1,GRCm39,707,1358,2196,707,1358,2196,0,0,0,5,64,32,A5,F4,C8
05_65_30,xcond_1,GRCm39,210,270,447,210,270,447,0,0,0,5,65,30,A5,F5,C6
05_65_57,xcond_1,GRCm39,320,408,703,319,407,702,1,1,1,5,65,57,A5,F5,E9
05_66_13,xcond_1,GRCm39,860,1247,2094,860,1247,2094,0,0,0,5,66,13,A5,F6,B1
05_66_35,xcond_1,GRCm39,1660,3056,5264,1658,3052,5256,2,4,8,5,66,35,A5,F6,C11
05_66_42,xcond_1,GRCm39,874,1458,2488,873,1457,2487,1,1,1,5,66,42,A5,F6,D6
05_66_45,xcond_1,GRCm39,264,319,563,264,319,563,0,0,0,5,66,45,A5,F6,D9
05_66_54,xcond_1,GRCm39,1353,2623,4391,1350,2619,4385,3,4,6,5,66,54,A5,F6,E6
05_66_64,xcond_1,GRCm39,459,611,1058,459,611,1058,0,0,0,5,66,64,A5,F6,F4
05_66_83,xcond_1,GRCm39,644,959,1598,644,959,1598,0,0,0,5,66,83,A5,F6,G11
05_68_18,xcond_1,GRCm39,1389,2515,4168,1385,2511,4164,4,4,4,5,68,18,A5,F8,B6
05_68_63,xcond_1,GRCm39,1065,1617,2710,1064,1616,2709,1,1,1,5,68,63,A5,F8,F3
05_68_78,xcond_1,GRCm39,600,985,1631,600,985,1631,0,0,0,5,68,78,A5,F8,G6
05_69_26,xcond_1,GRCm39,574,804,1281,574,804,1281,0,0,0,5,69,26,A5,F9,C2
05_69_41,xcond_1,GRCm39,159,217,327,159,217,327,0,0,0,5,69,41,A5,F9,D5
05_69_55,xcond_1,GRCm39,2582,6063,9730,2580,6052,9713,2,11,17,5,69,55,A5,F9,E7
05_69_57,xcond_1,GRCm39,362,469,763,361,468,762,1,1,1,5,69,57,A5,F9,E9
05_69_65,xcond_1,GRCm39,794,1425,2279,793,1423,2275,1,2,4,5,69,65,A5,F9,F5
05_70_05,xcond_1,GRCm39,322,428,681,322,428,681,0,0,0,5,70,5,A5,F10,A5
05_70_28,xcond_1,GRCm39,1491,2735,4520,1490,2734,4516,1,1,4,5,70,28,A5,F10,C4
05_70_41,xcond_1,GRCm39,777,1232,1982,776,1231,1981,1,1,1,5,70,41,A5,F10,D5
05_70_45,xcond_1,GRCm39,733,1157,1941,732,1156,1939,1,1,2,5,70,45,A5,F10,D9
05_70_73,xcond_1,GRCm39,1235,1948,3220,1233,1946,3217,2,2,3,5,70,73,A5,F10,G1
05_70_96,xcond_1,GRCm39,59,249,382,58,248,380,1,1,2,5,70,96,A5,F10,H12
05_71_02,xcond_1,GRCm39,598,789,1323,597,788,1322,1,1,1,5,71,2,A5,F11,A2
05_71_36,xcond_1,GRCm39,1108,1817,2932,1107,1816,2931,1,1,1,5,71,36,A5,F11,C12
05_71_96,xcond_1,GRCm39,985,1653,2726,985,1653,2726,0,0,0,5,71,96,A5,F11,H12
05_72_27,xcond_1,GRCm39,643,877,1435,642,876,1432,1,1,3,5,72,27,A5,F12,C3
05_72_87,xcond_1,GRCm39,641,1101,1777,639,1099,1771,2,2,6,5,72,87,A5,F12,H3
05_73_03,xcond_1,GRCm39,299,372,587,299,372,587,0,0,0,5,73,3,A5,G1,A3
05_73_09,xcond_1,GRCm39,1333,2151,3520,1332,2150,3519,1,1,1,5,73,9,A5,G1,A9
05_73_18,xcond_1,GRCm39,201,255,423,200,254,422,1,1,1,5,73,18,A5,G1,B6
05_73_21,xcond_1,GRCm39,578,839,1384,577,838,1380,1,1,4,5,73,21,A5,G1,B9
05_73_38,xcond_1,GRCm39,3173,7288,11913,3171,7285,11909,2,3,4,5,73,38,A5,G1,D2
05_73_42,xcond_1,GRCm39,437,689,1126,436,688,1123,1,1,3,5,73,42,A5,G1,D6
05_73_59,xcond_1,GRCm39,1193,2037,3303,1193,2037,3303,0,0,0,5,73,59,A5,G1,E11
05_73_93,xcond_1,GRCm39,461,611,1026,461,611,1026,0,0,0,5,73,93,A5,G1,H9
05_74_71,xcond_1,GRCm39,208,255,409,205,252,406,3,3,3,5,74,71,A5,G2,F11
05_74_83,xcond_1,GRCm39,591,845,1337,590,844,1336,1,1,1,5,74,83,A5,G2,G11
05_75_41,xcond_1,GRCm39,1341,2190,3618,1341,2190,3618,0,0,0,5,75,41,A5,G3,D5
05_75_42,xcond_1,GRCm39,993,1805,2876,991,1802,2870,2,3,6,5,75,42,A5,G3,D6
05_75_60,xcond_1,GRCm39,573,825,1322,573,825,1322,0,0,0,5,75,60,A5,G3,E12
05_75_67,xcond_1,GRCm39,516,801,1267,515,800,1266,1,1,1,5,75,67,A5,G3,F7
05_75_68,xcond_1,GRCm39,1255,2155,3558,1254,2153,3554,1,2,4,5,75,68,A5,G3,F8
05_75_87,xcond_1,GRCm39,195,236,380,195,236,380,0,0,0,5,75,87,A5,G3,H3
05_76_13,xcond_1,GRCm39,635,1002,1579,635,1002,1579,0,0,0,5,76,13,A5,G4,B1
05_77_02,xcond_1,GRCm39,434,654,1050,433,653,1045,1,1,5,5,77,2,A5,G5,A2
05_77_33,xcond_1,GRCm39,675,1199,1904,674,1198,1902,1,1,2,5,77,33,A5,G5,C9
05_77_37,xcond_1,GRCm39,416,590,954,416,590,954,0,0,0,5,77,37,A5,G5,D1
05_77_57,xcond_1,GRCm39,1053,1791,2888,1052,1789,2886,1,2,2,5,77,57,A5,G5,E9
05_78_33,xcond_1,GRCm39,909,1432,2380,909,1432,2380,0,0,0,5,78,33,A5,G6,C9
05_78_39,xcond_1,GRCm39,535,778,1230,534,776,1226,1,2,4,5,78,39,A5,G6,D3
05_78_47,xcond_1,GRCm39,317,474,812,317,474,812,0,0,0,5,78,47,A5,G6,D11
05_78_52,xcond_1,GRCm39,625,880,1425,624,879,1424,1,1,1,5,78,52,A5,G6,E4
05_78_73,xcond_1,GRCm39,337,516,848,337,516,848,0,0,0,5,78,73,A5,G6,G1
05_78_81,xcond_1,GRCm39,304,409,658,303,408,657,1,1,1,5,78,81,A5,G6,G9
05_79_36,xcond_1,GRCm39,1563,2828,4673,1559,2822,4667,4,6,6,5,79,36,A5,G7,C12
05_79_47,xcond_1,GRCm39,761,1220,1951,761,1220,1951,0,0,0,5,79,47,A5,G7,D11
05_79_49,xcond_1,GRCm39,598,993,1517,597,992,1515,1,1,2,5,79,49,A5,G7,E1
05_79_56,xcond_1,GRCm39,516,670,1101,516,670,1101,0,0,0,5,79,56,A5,G7,E8
05_79_92,xcond_1,GRCm39,839,1511,2499,837,1508,2495,2,3,4,5,79,92,A5,G7,H8
05_79_96,xcond_1,GRCm39,1061,1575,2541,1061,1575,2541,0,0,0,5,79,96,A5,G7,H12
05_80_05,xcond_1,GRCm39,220,272,434,219,271,433,1,1,1,5,80,5,A5,G8,A5
05_80_20,xcond_1,GRCm39,1059,1857,2919,1058,1856,2917,1,1,2,5,80,20,A5,G8,B8
05_80_38,xcond_1,GRCm39,1226,2289,3700,1224,2287,3698,2,2,2,5,80,38,A5,G8,D2
05_81_29,xcond_1,GRCm39,795,1174,1914,794,1173,1913,1,1,1,5,81,29,A5,G9,C5
05_81_44,xcond_1,GRCm39,1691,3168,5213,1690,3165,5209,1,3,4,5,81,44,A5,G9,D8
05_81_48,xcond_1,GRCm39,686,1058,1704,684,1056,1701,2,2,3,5,81,48,A5,G9,D12
05_81_64,xcond_1,GRCm39,689,1023,1688,688,1022,1686,1,1,2,5,81,64,A5,G9,F4
05_81_67,xcond_1,GRCm39,1242,2178,3569,1241,2175,3562,1,3,7,5,81,67,A5,G9,F7
05_81_73,xcond_1,GRCm39,1246,2299,3704,1244,2297,3702,2,2,2,5,81,73,A5,G9,G1
05_82_04,xcond_1,GRCm39,824,1562,2439,821,1559,2435,3,3,4,5,82,4,A5,G10,A4
05_82_19,xcond_1,GRCm39,295,404,659,294,402,656,1,2,3,5,82,19,A5,G10,B7
05_82_33,xcond_1,GRCm39,1590,2652,4351,1588,2650,4347,2,2,4,5,82,33,A5,G10,C9
05_82_45,xcond_1,GRCm39,259,347,528,259,347,528,0,0,0,5,82,45,A5,G10,D9
05_82_83,xcond_1,GRCm39,1114,1961,3153,1113,1960,3152,1,1,1,5,82,83,A5,G10,G11
05_83_23,xcond_1,GRCm39,242,423,658,242,423,658,0,0,0,5,83,23,A5,G11,B11
05_83_55,xcond_1,GRCm39,1064,1623,2620,1062,1621,2617,2,2,3,5,83,55,A5,G11,E7
05_84_02,xcond_1,GRCm39,688,1020,1622,688,1020,1622,0,0,0,5,84,2,A5,G12,A2
05_85_26,xcond_1,GRCm39,188,211,331,188,211,331,0,0,0,5,85,26,A5,H1,C2
05_85_59,xcond_1,GRCm39,3075,6920,11039,3072,6915,11033,3,5,6,5,85,59,A5,H1,E11
05_86_15,xcond_1,GRCm39,653,944,1552,652,942,1550,1,2,2,5,86,15,A5,H2,B3
05_86_21,xcond_1,GRCm39,177,261,452,177,261,452,0,0,0,5,86,21,A5,H2,B9
05_86_37,xcond_1,GRCm39,572,771,1259,571,770,1258,1,1,1,5,86,37,A5,H2,D1
05_86_43,xcond_1,GRCm39,224,262,420,224,262,420,0,0,0,5,86,43,A5,H2,D7
05_86_52,xcond_1,GRCm39,374,542,852,374,542,852,0,0,0,5,86,52,A5,H2,E4
05_86_55,xcond_1,GRCm39,443,597,994,442,596,993,1,1,1,5,86,55,A5,H2,E7
05_87_44,xcond_1,GRCm39,154,318,470,154,318,470,0,0,0,5,87,44,A5,H3,D8
05_87_63,xcond_1,GRCm39,465,767,1152,464,766,1150,1,1,2,5,87,63,A5,H3,F3
05_88_16,xcond_1,GRCm39,866,1366,2185,865,1365,2184,1,1,1,5,88,16,A5,H4,B4
05_88_81,xcond_1,GRCm39,200,227,377,200,227,377,0,0,0,5,88,81,A5,H4,G9
05_88_87,xcond_1,GRCm39,1011,1718,2691,1010,1717,2690,1,1,1,5,88,87,A5,H4,H3
05_89_11,xcond_1,GRCm39,212,264,427,211,263,425,1,1,2,5,89,11,A5,H5,A11
05_89_39,xcond_1,GRCm39,873,1434,2300,872,1433,2299,1,1,1,5,89,39,A5,H5,D3
05_89_83,xcond_1,GRCm39,998,1538,2520,995,1535,2516,3,3,4,5,89,83,A5,H5,G11
05_90_02,xcond_1,GRCm39,597,950,1549,596,949,1547,1,1,2,5,90,2,A5,H6,A2
05_90_42,xcond_1,GRCm39,326,479,801,326,479,801,0,0,0,5,90,42,A5,H6,D6
05_90_68,xcond_1,GRCm39,1826,3625,5987,1821,3617,5976,5,8,11,5,90,68,A5,H6,F8
05_90_69,xcond_1,GRCm39,384,638,1031,384,638,1031,0,0,0,5,90,69,A5,H6,F9
05_90_77,xcond_1,GRCm39,606,1171,1909,605,1170,1907,1,1,2,5,90,77,A5,H6,G5
05_90_84,xcond_1,GRCm39,1521,2711,4658,1520,2710,4657,1,1,1,5,90,84,A5,H6,G12
05_91_01,xcond_1,GRCm39,383,630,1047,382,629,1044,1,1,3,5,91,1,A5,H7,A1
05_91_26,xcond_1,GRCm39,347,436,733,346,435,732,1,1,1,5,91,26,A5,H7,C2
05_91_66,xcond_1,GRCm39,1034,1747,2855,1033,1746,2854,1,1,1,5,91,66,A5,H7,F6
05_91_75,xcond_1,GRCm39,773,1207,1982,772,1206,1979,1,1,3,5,91,75,A5,H7,G3
05_92_08,xcond_1,GRCm39,240,339,577,240,339,577,0,0,0,5,92,8,A5,H8,A8
05_92_15,xcond_1,GRCm39,729,1305,2101,728,1304,2100,1,1,1,5,92,15,A5,H8,B3
05_93_04,xcond_1,GRCm39,1735,4195,6701,1733,4191,6692,2,4,9,5,93,4,A5,H9,A4
05_93_06,xcond_1,GRCm39,542,734,1228,540,730,1223,2,4,5,5,93,6,A5,H9,A6
05_93_08,xcond_1,GRCm39,976,1591,2615,974,1588,2608,2,3,7,5,93,8,A5,H9,A8
05_93_45,xcond_1,GRCm39,279,318,505,279,318,505,0,0,0,5,93,45,A5,H9,D9
05_93_62,xcond_1,GRCm39,1123,1679,2759,1122,1678,2757,1,1,2,5,93,62,A5,H9,F2
05_93_80,xcond_1,GRCm39,952,1750,2839,951,1748,2832,1,2,7,5,93,80,A5,H9,G8
05_93_84,xcond_1,GRCm39,578,816,1360,577,815,1358,1,1,2,5,93,84,A5,H9,G12
05_94_13,xcond_1,GRCm39,3103,7173,11789,3096,7161,11771,7,12,18,5,94,13,A5,H10,B1
05_94_21,xcond_1,GRCm39,342,471,781,341,470,780,1,1,1,5,94,21,A5,H10,B9
05_94_23,xcond_1,GRCm39,460,632,1033,460,632,1033,0,0,0,5,94,23,A5,H10,B11
05_94_31,xcond_1,GRCm39,815,1107,1800,813,1105,1795,2,2,5,5,94,31,A5,H10,C7
05_94_45,xcond_1,GRCm39,621,870,1424,621,870,1424,0,0,0,5,94,45,A5,H10,D9
05_94_93,xcond_1,GRCm39,236,293,485,236,293,485,0,0,0,5,94,93,A5,H10,H9
05_95_07,xcond_1,GRCm39,615,1126,1855,615,1126,1855,0,0,0,5,95,7,A5,H11,A7
05_95_56,xcond_1,GRCm39,1463,2493,4110,1462,2492,4108,1,1,2,5,95,56,A5,H11,E8
05_96_25,xcond_1,GRCm39,297,424,692,297,424,692,0,0,0,5,96,25,A5,H12,C1
05_96_95,xcond_1,GRCm39,210,242,397,210,242,397,0,0,0,5,96,95,A5,H12,H11
06_01_07,xcond_1,GRCm39,1840,3571,5858,1836,3565,5846,4,6,12,6,1,7,A6,A1,A7
06_01_25,xcond_1,GRCm39,1084,1811,2955,1083,1808,2950,1,3,5,6,1,25,A6,A1,C1
06_01_29,xcond_1,GRCm39,499,667,1047,498,666,1046,1,1,1,6,1,29,A6,A1,C5
06_01_41,xcond_1,GRCm39,954,1454,2384,952,1452,2381,2,2,3,6,1,41,A6,A1,D5
06_01_68,xcond_1,GRCm39,672,982,1644,671,981,1640,1,1,4,6,1,68,A6,A1,F8
06_01_83,xcond_1,GRCm39,1198,2407,3920,1193,2402,3914,5,5,6,6,1,83,A6,A1,G11
06_02_04,xcond_1,GRCm39,237,272,439,237,272,439,0,0,0,6,2,4,A6,A2,A4
06_02_05,xcond_1,GRCm39,3182,7958,13184,3179,7951,13171,3,7,13,6,2,5,A6,A2,A5
06_02_18,xcond_1,GRCm39,293,369,594,293,369,594,0,0,0,6,2,18,A6,A2,B6
06_02_83,xcond_1,GRCm39,779,1238,2037,779,1238,2037,0,0,0,6,2,83,A6,A2,G11
06_03_05,xcond_1,GRCm39,3735,9147,14437,3731,9136,14419,4,11,18,6,3,5,A6,A3,A5
06_03_08,xcond_1,GRCm39,1981,4004,6311,1978,4000,6303,3,4,8,6,3,8,A6,A3,A8
06_03_36,xcond_1,GRCm39,541,807,1208,539,805,1206,2,2,2,6,3,36,A6,A3,C12
06_03_59,xcond_1,GRCm39,1259,2186,3462,1255,2180,3454,4,6,8,6,3,59,A6,A3,E11
06_03_64,xcond_1,GRCm39,1075,1750,2794,1075,1750,2794,0,0,0,6,3,64,A6,A3,F4
06_03_85,xcond_1,GRCm39,1518,2368,3746,1516,2366,3744,2,2,2,6,3,85,A6,A3,H1
06_03_92,xcond_1,GRCm39,945,1572,2481,943,1570,2477,2,2,4,6,3,92,A6,A3,H8
06_04_39,xcond_1,GRCm39,168,260,414,167,259,413,1,1,1,6,4,39,A6,A4,D3
06_04_44,xcond_1,GRCm39,863,1214,1992,862,1213,1990,1,1,2,6,4,44,A6,A4,D8
06_04_54,xcond_1,GRCm39,790,1223,1946,789,1222,1945,1,1,1,6,4,54,A6,A4,E6
06_04_93,xcond_1,GRCm39,335,400,651,335,400,651,0,0,0,6,4,93,A6,A4,H9
06_05_07,xcond_1,GRCm39,1553,2889,4624,1552,2887,4619,1,2,5,6,5,7,A6,A5,A7
06_05_09,xcond_1,GRCm39,528,743,1172,527,742,1171,1,1,1,6,5,9,A6,A5,A9
06_05_29,xcond_1,GRCm39,1318,2241,3550,1315,2238,3546,3,3,4,6,5,29,A6,A5,C5
06_05_51,xcond_1,GRCm39,617,878,1382,617,878,1382,0,0,0,6,5,51,A6,A5,E3
06_05_60,xcond_1,GRCm39,891,1381,2232,890,1380,2231,1,1,1,6,5,60,A6,A5,E12
06_06_09,xcond_1,GRCm39,192,232,367,192,232,367,0,0,0,6,6,9,A6,A6,A9
06_06_33,xcond_1,GRCm39,1833,3567,5859,1831,3564,5854,2,3,5,6,6,33,A6,A6,C9
06_06_50,xcond_1,GRCm39,416,668,1116,414,666,1113,2,2,3,6,6,50,A6,A6,E2
06_06_57,xcond_1,GRCm39,1239,1792,2954,1239,1792,2954,0,0,0,6,6,57,A6,A6,E9
06_06_75,xcond_1,GRCm39,2163,4043,6646,2160,4037,6640,3,6,6,6,6,75,A6,A6,G3
06_07_27,xcond_1,GRCm39,183,211,290,183,211,290,0,0,0,6,7,27,A6,A7,C3
06_07_45,xcond_1,GRCm39,1224,1899,3085,1223,1898,3084,1,1,1,6,7,45,A6,A7,D9
06_07_81,xcond_1,GRCm39,531,752,1223,529,750,1221,2,2,2,6,7,81,A6,A7,G9
06_07_95,xcond_1,GRCm39,3355,9026,14883,3352,9021,14874,3,5,9,6,7,95,A6,A7,H11
06_08_12,xcond_1,GRCm39,100,344,547,100,344,547,0,0,0,6,8,12,A6,A8,A12
06_08_20,xcond_1,GRCm39,769,1200,1952,769,1200,1952,0,0,0,6,8,20,A6,A8,B8
06_08_21,xcond_1,GRCm39,413,576,900,413,576,900,0,0,0,6,8,21,A6,A8,B9
06_08_40,xcond_1,GRCm39,386,537,888,384,535,882,2,2,6,6,8,40,A6,A8,D4
06_08_45,xcond_1,GRCm39,402,546,831,402,546,831,0,0,0,6,8,45,A6,A8,D9
06_08_57,xcond_1,GRCm39,307,408,670,307,408,670,0,0,0,6,8,57,A6,A8,E9
06_08_65,xcond_1,GRCm39,2089,4433,7105,2085,4429,7100,4,4,5,6,8,65,A6,A8,F5
06_09_21,xcond_1,GRCm39,302,375,628,302,375,628,0,0,0,6,9,21,A6,A9,B9
06_09_28,xcond_1,GRCm39,552,765,1303,551,764,1300,1,1,3,6,9,28,A6,A9,C4
06_09_40,xcond_1,GRCm39,606,977,1566,605,976,1565,1,1,1,6,9,40,A6,A9,D4
06_09_49,xcond_1,GRCm39,782,1271,2041,781,1270,2040,1,1,1,6,9,49,A6,A9,E1
06_09_56,xcond_1,GRCm39,1603,2780,4561,1600,2777,4558,3,3,3,6,9,56,A6,A9,E8
06_09_75,xcond_1,GRCm39,2421,5446,8867,2420,5445,8866,1,1,1,6,9,75,A6,A9,G3
06_10_17,xcond_1,GRCm39,1719,3365,5392,1717,3362,5386,2,3,6,6,10,17,A6,A10,B5
06_10_28,xcond_1,GRCm39,634,905,1493,634,905,1493,0,0,0,6,10,28,A6,A10,C4
06_10_29,xcond_1,GRCm39,562,738,1184,561,737,1182,1,1,2,6,10,29,A6,A10,C5
06_10_45,xcond_1,GRCm39,942,1485,2445,941,1484,2442,1,1,3,6,10,45,A6,A10,D9
06_10_52,xcond_1,GRCm39,431,579,958,431,579,958,0,0,0,6,10,52,A6,A10,E4
06_10_57,xcond_1,GRCm39,644,869,1463,643,868,1462,1,1,1,6,10,57,A6,A10,E9
06_10_90,xcond_1,GRCm39,187,229,382,187,229,382,0,0,0,6,10,90,A6,A10,H6
06_11_31,xcond_1,GRCm39,768,1097,1699,766,1094,1692,2,3,7,6,11,31,A6,A11,C7
06_11_32,xcond_1,GRCm39,876,1260,1969,874,1256,1964,2,4,5,6,11,32,A6,A11,C8
06_12_08,xcond_1,GRCm39,903,1613,2551,901,1611,2549,2,2,2,6,12,8,A6,A12,A8
06_12_09,xcond_1,GRCm39,718,991,1619,718,991,1619,0,0,0,6,12,9,A6,A12,A9
06_12_18,xcond_1,GRCm39,341,458,753,341,458,753,0,0,0,6,12,18,A6,A12,B6
06_12_24,xcond_1,GRCm39,569,827,1356,569,827,1356,0,0,0,6,12,24,A6,A12,B12
06_12_81,xcond_1,GRCm39,291,380,629,290,379,626,1,1,3,6,12,81,A6,A12,G9
06_12_91,xcond_1,GRCm39,1124,1967,3281,1122,1965,3279,2,2,2,6,12,91,A6,A12,H7
06_13_07,xcond_1,GRCm39,1127,1745,2805,1126,1743,2803,1,2,2,6,13,7,A6,B1,A7
06_13_33,xcond_1,GRCm39,406,513,829,406,513,829,0,0,0,6,13,33,A6,B1,C9
06_13_38,xcond_1,GRCm39,1322,2179,3633,1319,2176,3630,3,3,3,6,13,38,A6,B1,D2
06_13_71,xcond_1,GRCm39,1074,1700,2756,1073,1699,2755,1,1,1,6,13,71,A6,B1,F11
06_13_78,xcond_1,GRCm39,182,219,315,182,219,315,0,0,0,6,13,78,A6,B1,G6
06_13_87,xcond_1,GRCm39,1236,2192,3557,1233,2189,3554,3,3,3,6,13,87,A6,B1,H3
06_14_67,xcond_1,GRCm39,448,645,1074,447,644,1073,1,1,1,6,14,67,A6,B2,F7
06_15_19,xcond_1,GRCm39,416,652,1010,416,652,1010,0,0,0,6,15,19,A6,B3,B7
06_15_24,xcond_1,GRCm39,440,577,926,440,577,926,0,0,0,6,15,24,A6,B3,B12
06_15_35,xcond_1,GRCm39,915,1473,2348,915,1473,2348,0,0,0,6,15,35,A6,B3,C11
06_15_76,xcond_1,GRCm39,1338,2013,3240,1335,2009,3236,3,4,4,6,15,76,A6,B3,G4
06_15_88,xcond_1,GRCm39,672,891,1455,669,888,1450,3,3,5,6,15,88,A6,B3,H4
06_15_92,xcond_1,GRCm39,1444,3131,5007,1442,3129,5004,2,2,3,6,15,92,A6,B3,H8
06_16_21,xcond_1,GRCm39,136,224,361,136,224,361,0,0,0,6,16,21,A6,B4,B9
06_16_64,xcond_1,GRCm39,385,486,704,385,486,704,0,0,0,6,16,64,A6,B4,F4
06_16_85,xcond_1,GRCm39,1115,1685,2837,1113,1683,2830,2,2,7,6,16,85,A6,B4,H1
06_16_89,xcond_1,GRCm39,1836,3148,5180,1833,3145,5177,3,3,3,6,16,89,A6,B4,H5
06_17_30,xcond_1,GRCm39,213,269,445,213,269,445,0,0,0,6,17,30,A6,B5,C6
06_17_64,xcond_1,GRCm39,1080,1747,2844,1078,1745,2842,2,2,2,6,17,64,A6,B5,F4
06_18_28,xcond_1,GRCm39,881,1374,2196,880,1373,2195,1,1,1,6,18,28,A6,B6,C4
06_18_32,xcond_1,GRCm39,1196,2044,3265,1194,2041,3260,2,3,5,6,18,32,A6,B6,C8
06_19_08,xcond_1,GRCm39,2762,6108,9897,2759,6104,9891,3,4,6,6,19,8,A6,B7,A8
06_19_32,xcond_1,GRCm39,3378,9144,14893,3371,9132,14875,7,12,18,6,19,32,A6,B7,C8
06_19_35,xcond_1,GRCm39,2075,3648,5883,2074,3647,5881,1,1,2,6,19,35,A6,B7,C11
06_20_12,xcond_1,GRCm39,375,444,685,374,443,684,1,1,1,6,20,12,A6,B8,A12
06_20_56,xcond_1,GRCm39,847,1325,2158,846,1324,2157,1,1,1,6,20,56,A6,B8,E8
06_20_71,xcond_1,GRCm39,708,2453,3833,707,2452,3831,1,1,2,6,20,71,A6,B8,F11
06_20_72,xcond_1,GRCm39,806,1214,2003,805,1213,2002,1,1,1,6,20,72,A6,B8,F12
06_20_79,xcond_1,GRCm39,655,1025,1715,655,1025,1715,0,0,0,6,20,79,A6,B8,G7
06_21_66,xcond_1,GRCm39,182,334,557,181,333,556,1,1,1,6,21,66,A6,B9,F6
06_22_57,xcond_1,GRCm39,1920,3372,5551,1918,3370,5548,2,2,3,6,22,57,A6,B10,E9
06_22_75,xcond_1,GRCm39,609,866,1434,607,864,1431,2,2,3,6,22,75,A6,B10,G3
06_22_87,xcond_1,GRCm39,1144,1923,3188,1140,1917,3179,4,6,9,6,22,87,A6,B10,H3
06_23_29,xcond_1,GRCm39,1010,1486,2340,1009,1485,2338,1,1,2,6,23,29,A6,B11,C5
06_23_91,xcond_1,GRCm39,1859,3593,5841,1856,3589,5836,3,4,5,6,23,91,A6,B11,H7
06_24_30,xcond_1,GRCm39,1156,1932,3204,1155,1930,3201,1,2,3,6,24,30,A6,B12,C6
06_24_32,xcond_1,GRCm39,61,244,388,61,244,388,0,0,0,6,24,32,A6,B12,C8
06_24_53,xcond_1,GRCm39,904,1443,2346,903,1442,2345,1,1,1,6,24,53,A6,B12,E5
06_25_29,xcond_1,GRCm39,605,870,1418,604,869,1417,1,1,1,6,25,29,A6,C1,C5
06_25_41,xcond_1,GRCm39,939,1546,2573,939,1546,2573,0,0,0,6,25,41,A6,C1,D5
06_25_62,xcond_1,GRCm39,345,471,778,345,471,778,0,0,0,6,25,62,A6,C1,F2
06_25_79,xcond_1,GRCm39,392,517,862,391,516,861,1,1,1,6,25,79,A6,C1,G7
06_25_81,xcond_1,GRCm39,1016,1477,2467,1014,1475,2462,2,2,5,6,25,81,A6,C1,G9
06_26_01,xcond_1,GRCm39,865,1235,2046,864,1233,2043,1,2,3,6,26,1,A6,C2,A1
06_26_13,xcond_1,GRCm39,427,568,919,427,568,919,0,0,0,6,26,13,A6,C2,B1
06_26_27,xcond_1,GRCm39,489,661,1085,488,660,1084,1,1,1,6,26,27,A6,C2,C3
06_26_37,xcond_1,GRCm39,606,961,1553,604,959,1550,2,2,3,6,26,37,A6,C2,D1
06_27_26,xcond_1,GRCm39,849,1434,2341,846,1431,2336,3,3,5,6,27,26,A6,C3,C2
06_27_71,xcond_1,GRCm39,504,660,1034,504,660,1034,0,0,0,6,27,71,A6,C3,F11
06_27_81,xcond_1,GRCm39,885,1351,2142,882,1348,2139,3,3,3,6,27,81,A6,C3,G9
06_28_23,xcond_1,GRCm39,412,558,946,411,557,945,1,1,1,6,28,23,A6,C4,B11
06_28_62,xcond_1,GRCm39,1685,2913,4723,1683,2911,4721,2,2,2,6,28,62,A6,C4,F2
06_30_25,xcond_1,GRCm39,1087,1674,2703,1085,1672,2699,2,2,4,6,30,25,A6,C6,C1
06_31_07,xcond_1,GRCm39,456,588,940,456,588,940,0,0,0,6,31,7,A6,C7,A7
06_31_27,xcond_1,GRCm39,2845,6084,9805,2842,6077,9792,3,7,13,6,31,27,A6,C7,C3
06_31_76,xcond_1,GRCm39,1986,3769,6087,1984,3767,6084,2,2,3,6,31,76,A6,C7,G4
06_32_50,xcond_1,GRCm39,292,417,681,291,416,680,1,1,1,6,32,50,A6,C8,E2
06_32_52,xcond_1,GRCm39,844,1381,2253,843,1379,2251,1,2,2,6,32,52,A6,C8,E4
06_32_67,xcond_1,GRCm39,908,1419,2320,908,1419,2320,0,0,0,6,32,67,A6,C8,F7
06_32_84,xcond_1,GRCm39,334,434,643,334,434,643,0,0,0,6,32,84,A6,C8,G12
06_32_95,xcond_1,GRCm39,373,461,763,373,461,763,0,0,0,6,32,95,A6,C8,H11
06_33_11,xcond_1,GRCm39,366,464,765,366,464,765,0,0,0,6,33,11,A6,C9,A11
06_33_23,xcond_1,GRCm39,652,973,1567,650,971,1565,2,2,2,6,33,23,A6,C9,B11
06_33_28,xcond_1,GRCm39,260,324,516,260,324,516,0,0,0,6,33,28,A6,C9,C4
06_33_35,xcond_1,GRCm39,1350,2162,3466,1349,2161,3465,1,1,1,6,33,35,A6,C9,C11
06_34_45,xcond_1,GRCm39,727,1064,1715,725,1062,1713,2,2,2,6,34,45,A6,C10,D9
06_34_51,xcond_1,GRCm39,1979,4390,7146,1977,4386,7141,2,4,5,6,34,51,A6,C10,E3
06_34_77,xcond_1,GRCm39,851,1450,2350,850,1449,2349,1,1,1,6,34,77,A6,C10,G5
06_34_95,xcond_1,GRCm39,898,1355,2175,898,1355,2175,0,0,0,6,34,95,A6,C10,H11
06_35_04,xcond_1,GRCm39,2411,4769,7783,2408,4765,7777,3,4,6,6,35,4,A6,C11,A4
06_35_35,xcond_1,GRCm39,554,835,1325,554,835,1325,0,0,0,6,35,35,A6,C11,C11
06_35_67,xcond_1,GRCm39,1321,2370,3767,1320,2369,3766,1,1,1,6,35,67,A6,C11,F7
06_36_14,xcond_1,GRCm39,407,575,915,407,575,915,0,0,0,6,36,14,A6,C12,B2
06_36_32,xcond_1,GRCm39,1318,2288,3756,1318,2288,3756,0,0,0,6,36,32,A6,C12,C8
06_36_37,xcond_1,GRCm39,2129,4296,6945,2126,4291,6937,3,5,8,6,36,37,A6,C12,D1
06_36_52,xcond_1,GRCm39,499,661,960,498,660,957,1,1,3,6,36,52,A6,C12,E4
06_36_72,xcond_1,GRCm39,706,1036,1698,706,1036,1698,0,0,0,6,36,72,A6,C12,F12
06_37_76,xcond_1,GRCm39,831,1299,2124,830,1298,2123,1,1,1,6,37,76,A6,D1,G4
06_37_84,xcond_1,GRCm39,378,477,804,378,477,804,0,0,0,6,37,84,A6,D1,G12
06_38_02,xcond_1,GRCm39,1506,2885,4693,1505,2884,4691,1,1,2,6,38,2,A6,D2,A2
06_38_64,xcond_1,GRCm39,1283,2020,3357,1282,2019,3356,1,1,1,6,38,64,A6,D2,F4
06_38_72,xcond_1,GRCm39,1088,1803,2976,1086,1801,2974,2,2,2,6,38,72,A6,D2,F12
06_39_28,xcond_1,GRCm39,585,748,1144,584,747,1141,1,1,3,6,39,28,A6,D3,C4
06_39_55,xcond_1,GRCm39,1212,2124,3341,1210,2121,3336,2,3,5,6,39,55,A6,D3,E7
06_39_62,xcond_1,GRCm39,174,205,306,174,205,306,0,0,0,6,39,62,A6,D3,F2
06_39_65,xcond_1,GRCm39,149,222,377,149,222,377,0,0,0,6,39,65,A6,D3,F5
06_39_67,xcond_1,GRCm39,1642,3001,4791,1639,2998,4788,3,3,3,6,39,67,A6,D3,F7
06_39_74,xcond_1,GRCm39,1110,1868,2978,1108,1866,2976,2,2,2,6,39,74,A6,D3,G2
06_39_83,xcond_1,GRCm39,491,688,1128,491,688,1128,0,0,0,6,39,83,A6,D3,G11
06_40_48,xcond_1,GRCm39,1472,2489,4090,1471,2485,4086,1,4,4,6,40,48,A6,D4,D12
06_40_96,xcond_1,GRCm39,1423,2449,4082,1422,2448,4081,1,1,1,6,40,96,A6,D4,H12
06_41_18,xcond_1,GRCm39,1156,1979,3290,1154,1977,3288,2,2,2,6,41,18,A6,D5,B6
06_41_59,xcond_1,GRCm39,1064,1669,2797,1063,1668,2796,1,1,1,6,41,59,A6,D5,E11
06_41_87,xcond_1,GRCm39,805,1262,2038,805,1262,2038,0,0,0,6,41,87,A6,D5,H3
06_42_21,xcond_1,GRCm39,2277,4290,7117,2275,4287,7112,2,3,5,6,42,21,A6,D6,B9
06_42_84,xcond_1,GRCm39,1158,2058,3156,1155,2055,3152,3,3,4,6,42,84,A6,D6,G12
06_42_87,xcond_1,GRCm39,1692,2995,4721,1690,2993,4717,2,2,4,6,42,87,A6,D6,H3
06_43_45,xcond_1,GRCm39,764,1183,1902,763,1181,1900,1,2,2,6,43,45,A6,D7,D9
06_43_53,xcond_1,GRCm39,1647,3157,5153,1646,3156,5152,1,1,1,6,43,53,A6,D7,E5
06_43_62,xcond_1,GRCm39,841,1294,2060,838,1291,2054,3,3,6,6,43,62,A6,D7,F2
06_43_77,xcond_1,GRCm39,823,1225,2017,821,1222,2014,2,3,3,6,43,77,A6,D7,G5
06_43_81,xcond_1,GRCm39,729,1107,1793,729,1107,1793,0,0,0,6,43,81,A6,D7,G9
06_43_84,xcond_1,GRCm39,995,1648,2629,994,1644,2624,1,4,5,6,43,84,A6,D7,G12
06_43_92,xcond_1,GRCm39,127,245,385,126,244,384,1,1,1,6,43,92,A6,D7,H8
06_44_14,xcond_1,GRCm39,1287,2031,3301,1286,2030,3299,1,1,2,6,44,14,A6,D8,B2
06_44_17,xcond_1,GRCm39,669,958,1531,669,958,1531,0,0,0,6,44,17,A6,D8,B5
06_44_36,xcond_1,GRCm39,790,1214,1892,788,1212,1888,2,2,4,6,44,36,A6,D8,C12
06_44_48,xcond_1,GRCm39,4023,10646,16815,4018,10636,16804,5,10,11,6,44,48,A6,D8,D12
06_44_51,xcond_1,GRCm39,870,1487,2366,870,1487,2366,0,0,0,6,44,51,A6,D8,E3
06_44_55,xcond_1,GRCm39,803,1300,1978,801,1298,1975,2,2,3,6,44,55,A6,D8,E7
06_44_76,xcond_1,GRCm39,816,1141,1858,814,1139,1856,2,2,2,6,44,76,A6,D8,G4
06_45_03,xcond_1,GRCm39,1172,2087,3434,1170,2082,3428,2,5,6,6,45,3,A6,D9,A3
06_45_21,xcond_1,GRCm39,379,485,826,378,484,825,1,1,1,6,45,21,A6,D9,B9
06_45_32,xcond_1,GRCm39,311,397,636,309,395,634,2,2,2,6,45,32,A6,D9,C8
06_45_65,xcond_1,GRCm39,856,1250,2089,854,1248,2086,2,2,3,6,45,65,A6,D9,F5
06_45_69,xcond_1,GRCm39,344,486,746,344,486,746,0,0,0,6,45,69,A6,D9,F9
06_46_01,xcond_1,GRCm39,428,530,850,428,530,850,0,0,0,6,46,1,A6,D10,A1
06_46_21,xcond_1,GRCm39,947,1558,2528,945,1555,2525,2,3,3,6,46,21,A6,D10,B9
06_46_25,xcond_1,GRCm39,826,1151,1917,825,1150,1915,1,1,2,6,46,25,A6,D10,C1
06_46_67,xcond_1,GRCm39,691,1074,1740,691,1074,1740,0,0,0,6,46,67,A6,D10,F7
06_46_88,xcond_1,GRCm39,1305,2234,3723,1304,2233,3722,1,1,1,6,46,88,A6,D10,H4
06_47_15,xcond_1,GRCm39,1018,1513,2484,1015,1509,2478,3,4,6,6,47,15,A6,D11,B3
06_47_67,xcond_1,GRCm39,691,958,1494,690,957,1493,1,1,1,6,47,67,A6,D11,F7
06_48_48,xcond_1,GRCm39,884,1555,2505,883,1554,2504,1,1,1,6,48,48,A6,D12,D12
06_48_60,xcond_1,GRCm39,887,1357,2233,887,1357,2233,0,0,0,6,48,60,A6,D12,E12
06_48_62,xcond_1,GRCm39,830,1231,1985,830,1231,1985,0,0,0,6,48,62,A6,D12,F2
06_49_81,xcond_1,GRCm39,299,372,627,298,371,626,1,1,1,6,49,81,A6,E1,G9
06_50_08,xcond_1,GRCm39,185,231,338,185,231,338,0,0,0,6,50,8,A6,E2,A8
06_50_33,xcond_1,GRCm39,745,1236,2055,744,1235,2053,1,1,2,6,50,33,A6,E2,C9
06_50_52,xcond_1,GRCm39,812,1268,2033,812,1268,2033,0,0,0,6,50,52,A6,E2,E4
06_50_81,xcond_1,GRCm39,3323,7703,12801,3319,7696,12790,4,7,11,6,50,81,A6,E2,G9
06_50_83,xcond_1,GRCm39,243,379,604,242,377,595,1,2,9,6,50,83,A6,E2,G11
06_51_09,xcond_1,GRCm39,282,367,614,281,366,613,1,1,1,6,51,9,A6,E3,A9
06_51_12,xcond_1,GRCm39,1226,1974,3200,1226,1974,3200,0,0,0,6,51,12,A6,E3,A12
06_51_33,xcond_1,GRCm39,710,1068,1760,710,1068,1760,0,0,0,6,51,33,A6,E3,C9
06_51_43,xcond_1,GRCm39,1412,2606,4315,1409,2601,4310,3,5,5,6,51,43,A6,E3,D7
06_51_45,xcond_1,GRCm39,377,555,917,377,555,917,0,0,0,6,51,45,A6,E3,D9
06_52_30,xcond_1,GRCm39,1088,1845,3045,1087,1842,3040,1,3,5,6,52,30,A6,E4,C6
06_52_42,xcond_1,GRCm39,1114,1943,3152,1114,1943,3152,0,0,0,6,52,42,A6,E4,D6
06_52_60,xcond_1,GRCm39,1228,2008,3222,1228,2008,3222,0,0,0,6,52,60,A6,E4,E12
06_53_24,xcond_1,GRCm39,219,269,417,219,269,417,0,0,0,6,53,24,A6,E5,B12
06_53_33,xcond_1,GRCm39,1054,1743,2754,1052,1739,2748,2,4,6,6,53,33,A6,E5,C9
06_53_45,xcond_1,GRCm39,418,552,885,418,552,885,0,0,0,6,53,45,A6,E5,D9
06_53_73,xcond_1,GRCm39,1612,2592,4188,1610,2589,4184,2,3,4,6,53,73,A6,E5,G1
06_54_02,xcond_1,GRCm39,603,893,1460,602,892,1459,1,1,1,6,54,2,A6,E6,A2
06_54_13,xcond_1,GRCm39,823,1581,2616,822,1580,2615,1,1,1,6,54,13,A6,E6,B1
06_54_20,xcond_1,GRCm39,1364,2750,4596,1363,2746,4588,1,4,8,6,54,20,A6,E6,B8
06_54_39,xcond_1,GRCm39,1438,2596,4335,1437,2594,4333,1,2,2,6,54,39,A6,E6,D3
06_54_41,xcond_1,GRCm39,1784,3169,5240,1783,3168,5239,1,1,1,6,54,41,A6,E6,D5
06_54_50,xcond_1,GRCm39,753,1230,2046,752,1229,2045,1,1,1,6,54,50,A6,E6,E2
06_54_69,xcond_1,GRCm39,575,815,1373,575,815,1373,0,0,0,6,54,69,A6,E6,F9
06_55_05,xcond_1,GRCm39,495,713,1223,495,713,1223,0,0,0,6,55,5,A6,E7,A5
06_55_65,xcond_1,GRCm39,207,296,482,207,296,482,0,0,0,6,55,65,A6,E7,F5
06_56_07,xcond_1,GRCm39,1243,2113,3496,1242,2112,3495,1,1,1,6,56,7,A6,E8,A7
06_57_03,xcond_1,GRCm39,1199,2015,3292,1199,2015,3292,0,0,0,6,57,3,A6,E9,A3
06_57_26,xcond_1,GRCm39,1353,2244,3794,1352,2243,3793,1,1,1,6,57,26,A6,E9,C2
06_57_56,xcond_1,GRCm39,887,1548,2577,886,1547,2575,1,1,2,6,57,56,A6,E9,E8
06_57_96,xcond_1,GRCm39,2381,4841,8114,2379,4837,8110,2,4,4,6,57,96,A6,E9,H12
06_58_16,xcond_1,GRCm39,209,237,326,209,237,326,0,0,0,6,58,16,A6,E10,B4
06_58_63,xcond_1,GRCm39,399,536,823,399,536,823,0,0,0,6,58,63,A6,E10,F3
06_58_81,xcond_1,GRCm39,1414,2290,3688,1412,2287,3685,2,3,3,6,58,81,A6,E10,G9
06_58_84,xcond_1,GRCm39,1411,2439,4036,1409,2436,4032,2,3,4,6,58,84,A6,E10,G12
06_59_57,xcond_1,GRCm39,509,646,1055,508,645,1053,1,1,2,6,59,57,A6,E11,E9
06_59_61,xcond_1,GRCm39,2629,5904,9515,2628,5902,9512,1,2,3,6,59,61,A6,E11,F1
06_60_01,xcond_1,GRCm39,738,1212,2065,737,1211,2063,1,1,2,6,60,1,A6,E12,A1
06_60_30,xcond_1,GRCm39,1719,3026,5081,1715,3020,5072,4,6,9,6,60,30,A6,E12,C6
06_60_67,xcond_1,GRCm39,3030,6749,10998,3025,6743,10990,5,6,8,6,60,67,A6,E12,F7
06_61_47,xcond_1,GRCm39,1071,1994,3217,1068,1990,3211,3,4,6,6,61,47,A6,F1,D11
06_61_74,xcond_1,GRCm39,843,1298,2173,841,1296,2171,2,2,2,6,61,74,A6,F1,G2
06_61_81,xcond_1,GRCm39,749,1198,1936,747,1196,1933,2,2,3,6,61,81,A6,F1,G9
06_62_35,xcond_1,GRCm39,641,810,1321,641,810,1321,0,0,0,6,62,35,A6,F2,C11
06_62_63,xcond_1,GRCm39,2008,3973,6593,2006,3971,6591,2,2,2,6,62,63,A6,F2,F3
06_62_85,xcond_1,GRCm39,1162,2020,3309,1160,2015,3303,2,5,6,6,62,85,A6,F2,H1
06_63_02,xcond_1,GRCm39,918,1482,2385,915,1477,2380,3,5,5,6,63,2,A6,F3,A2
06_63_19,xcond_1,GRCm39,1106,1816,2923,1103,1813,2920,3,3,3,6,63,19,A6,F3,B7
06_63_53,xcond_1,GRCm39,1670,3331,5367,1669,3329,5365,1,2,2,6,63,53,A6,F3,E5
06_64_03,xcond_1,GRCm39,640,884,1485,638,882,1482,2,2,3,6,64,3,A6,F4,A3
06_64_78,xcond_1,GRCm39,1003,1560,2581,1003,1560,2581,0,0,0,6,64,78,A6,F4,G6
06_64_91,xcond_1,GRCm39,1284,2490,4167,1283,2489,4166,1,1,1,6,64,91,A6,F4,H7
06_65_14,xcond_1,GRCm39,104,478,767,104,478,767,0,0,0,6,65,14,A6,F5,B2
06_66_19,xcond_1,GRCm39,753,1258,2110,753,1258,2110,0,0,0,6,66,19,A6,F6,B7
06_66_50,xcond_1,GRCm39,1229,2037,3465,1228,2036,3464,1,1,1,6,66,50,A6,F6,E2
06_66_60,xcond_1,GRCm39,1687,3087,5316,1685,3085,5314,2,2,2,6,66,60,A6,F6,E12
06_66_64,xcond_1,GRCm39,830,1279,2106,830,1279,2106,0,0,0,6,66,64,A6,F6,F4
06_66_73,xcond_1,GRCm39,889,1542,2535,888,1539,2528,1,3,7,6,66,73,A6,F6,G1
06_66_74,xcond_1,GRCm39,1083,1853,3200,1082,1849,3191,1,4,9,6,66,74,A6,F6,G2
06_66_85,xcond_1,GRCm39,1637,2725,4624,1635,2723,4622,2,2,2,6,66,85,A6,F6,H1
06_67_09,xcond_1,GRCm39,275,352,556,275,352,556,0,0,0,6,67,9,A6,F7,A9
06_67_61,xcond_1,GRCm39,900,1418,2322,897,1414,2317,3,4,5,6,67,61,A6,F7,F1
06_68_14,xcond_1,GRCm39,794,1240,1985,794,1240,1985,0,0,0,6,68,14,A6,F8,B2
06_68_17,xcond_1,GRCm39,1414,2295,3713,1414,2295,3713,0,0,0,6,68,17,A6,F8,B5
06_68_21,xcond_1,GRCm39,325,413,679,325,413,679,0,0,0,6,68,21,A6,F8,B9
06_68_55,xcond_1,GRCm39,454,598,962,454,598,962,0,0,0,6,68,55,A6,F8,E7
06_68_80,xcond_1,GRCm39,567,751,1255,567,751,1255,0,0,0,6,68,80,A6,F8,G8
06_69_03,xcond_1,GRCm39,1626,3249,5190,1623,3244,5182,3,5,8,6,69,3,A6,F9,A3
06_69_09,xcond_1,GRCm39,256,318,495,256,318,495,0,0,0,6,69,9,A6,F9,A9
06_69_29,xcond_1,GRCm39,1899,3765,5927,1896,3760,5920,3,5,7,6,69,29,A6,F9,C5
06_69_41,xcond_1,GRCm39,7138,37279,59483,7131,37257,59451,7,22,32,6,69,41,A6,F9,D5
06_69_66,xcond_1,GRCm39,1608,2862,4611,1606,2860,4609,2,2,2,6,69,66,A6,F9,F6
06_69_73,xcond_1,GRCm39,658,898,1408,658,898,1408,0,0,0,6,69,73,A6,F9,G1
06_70_11,xcond_1,GRCm39,178,227,330,178,227,330,0,0,0,6,70,11,A6,F10,A11
06_70_44,xcond_1,GRCm39,818,1261,2076,817,1259,2074,1,2,2,6,70,44,A6,F10,D8
06_70_68,xcond_1,GRCm39,2089,3633,6049,2087,3631,6046,2,2,3,6,70,68,A6,F10,F8
06_70_93,xcond_1,GRCm39,180,211,343,180,211,343,0,0,0,6,70,93,A6,F10,H9
06_70_96,xcond_1,GRCm39,664,1103,1743,663,1102,1742,1,1,1,6,70,96,A6,F10,H12
06_71_47,xcond_1,GRCm39,588,798,1367,587,797,1366,1,1,1,6,71,47,A6,F11,D11
06_71_80,xcond_1,GRCm39,1634,2821,4550,1632,2818,4547,2,3,3,6,71,80,A6,F11,G8
06_71_93,xcond_1,GRCm39,724,1118,1853,724,1118,1853,0,0,0,6,71,93,A6,F11,H9
06_72_04,xcond_1,GRCm39,2073,4191,6931,2071,4189,6929,2,2,2,6,72,4,A6,F12,A4
06_72_15,xcond_1,GRCm39,787,1189,1983,786,1188,1982,1,1,1,6,72,15,A6,F12,B3
06_73_02,xcond_1,GRCm39,2177,4060,6698,2176,4058,6695,1,2,3,6,73,2,A6,G1,A2
06_73_13,xcond_1,GRCm39,1715,3640,5846,1713,3638,5844,2,2,2,6,73,13,A6,G1,B1
06_73_18,xcond_1,GRCm39,1379,2793,4588,1378,2792,4587,1,1,1,6,73,18,A6,G1,B6
06_73_21,xcond_1,GRCm39,353,482,769,353,482,769,0,0,0,6,73,21,A6,G1,B9
06_73_44,xcond_1,GRCm39,1634,3031,5032,1632,3028,5027,2,3,5,6,73,44,A6,G1,D8
06_73_81,xcond_1,GRCm39,530,689,1134,528,687,1129,2,2,5,6,73,81,A6,G1,G9
06_73_92,xcond_1,GRCm39,3483,8077,13110,3480,8074,13107,3,3,3,6,73,92,A6,G1,H8
06_73_95,xcond_1,GRCm39,977,1480,2446,975,1478,2444,2,2,2,6,73,95,A6,G1,H11
06_74_19,xcond_1,GRCm39,3772,9658,15550,3768,9652,15541,4,6,9,6,74,19,A6,G2,B7
06_74_25,xcond_1,GRCm39,925,1441,2274,923,1438,2270,2,3,4,6,74,25,A6,G2,C1
06_74_54,xcond_1,GRCm39,958,1581,2510,957,1580,2508,1,1,2,6,74,54,A6,G2,E6
06_74_60,xcond_1,GRCm39,1023,1639,2708,1021,1637,2706,2,2,2,6,74,60,A6,G2,E12
06_74_61,xcond_1,GRCm39,654,870,1372,654,870,1372,0,0,0,6,74,61,A6,G2,F1
06_74_62,xcond_1,GRCm39,435,749,1201,434,748,1200,1,1,1,6,74,62,A6,G2,F2
06_74_68,xcond_1,GRCm39,374,508,833,374,508,833,0,0,0,6,74,68,A6,G2,F8
06_74_73,xcond_1,GRCm39,214,287,453,214,287,453,0,0,0,6,74,73,A6,G2,G1
06_74_84,xcond_1,GRCm39,553,729,1159,552,728,1158,1,1,1,6,74,84,A6,G2,G12
06_74_91,xcond_1,GRCm39,165,209,297,165,209,297,0,0,0,6,74,91,A6,G2,H7
06_75_20,xcond_1,GRCm39,2521,4946,8041,2518,4941,8036,3,5,5,6,75,20,A6,G3,B8
06_75_79,xcond_1,GRCm39,265,303,530,265,303,530,0,0,0,6,75,79,A6,G3,G7
06_75_81,xcond_1,GRCm39,646,939,1558,645,938,1556,1,1,2,6,75,81,A6,G3,G9
06_75_96,xcond_1,GRCm39,999,1669,2703,999,1669,2703,0,0,0,6,75,96,A6,G3,H12
06_76_08,xcond_1,GRCm39,244,301,494,244,301,494,0,0,0,6,76,8,A6,G4,A8
06_76_40,xcond_1,GRCm39,949,1629,2660,947,1627,2657,2,2,3,6,76,40,A6,G4,D4
06_77_73,xcond_1,GRCm39,1028,1806,2915,1027,1805,2914,1,1,1,6,77,73,A6,G5,G1
06_78_12,xcond_1,GRCm39,384,460,732,384,460,732,0,0,0,6,78,12,A6,G6,A12
06_78_52,xcond_1,GRCm39,565,776,1291,565,776,1291,0,0,0,6,78,52,A6,G6,E4
06_78_72,xcond_1,GRCm39,612,836,1377,612,836,1377,0,0,0,6,78,72,A6,G6,F12
06_78_74,xcond_1,GRCm39,801,1251,2060,801,1251,2060,0,0,0,6,78,74,A6,G6,G2
06_78_81,xcond_1,GRCm39,667,970,1589,665,968,1587,2,2,2,6,78,81,A6,G6,G9
06_79_81,xcond_1,GRCm39,526,722,1236,526,722,1236,0,0,0,6,79,81,A6,G7,G9
06_80_60,xcond_1,GRCm39,300,385,657,300,385,657,0,0,0,6,80,60,A6,G8,E12
06_80_76,xcond_1,GRCm39,1171,1928,3120,1168,1925,3113,3,3,7,6,80,76,A6,G8,G4
06_80_93,xcond_1,GRCm39,218,274,463,217,273,461,1,1,2,6,80,93,A6,G8,H9
06_81_69,xcond_1,GRCm39,486,710,1137,485,709,1135,1,1,2,6,81,69,A6,G9,F9
06_82_71,xcond_1,GRCm39,726,1173,1869,725,1172,1868,1,1,1,6,82,71,A6,G10,F11
06_82_76,xcond_1,GRCm39,765,1118,1884,765,1118,1884,0,0,0,6,82,76,A6,G10,G4
06_83_03,xcond_1,GRCm39,881,1327,2105,880,1326,2104,1,1,1,6,83,3,A6,G11,A3
06_83_31,xcond_1,GRCm39,498,692,1055,497,691,1054,1,1,1,6,83,31,A6,G11,C7
06_83_56,xcond_1,GRCm39,6016,24318,39316,6008,24304,39300,8,14,16,6,83,56,A6,G11,E8
06_83_62,xcond_1,GRCm39,481,676,1103,479,674,1100,2,2,3,6,83,62,A6,G11,F2
06_84_96,xcond_1,GRCm39,216,277,424,215,276,423,1,1,1,6,84,96,A6,G12,H12
06_85_09,xcond_1,GRCm39,1761,2627,4237,1760,2626,4236,1,1,1,6,85,9,A6,H1,A9
06_85_20,xcond_1,GRCm39,1932,4081,6442,1930,4079,6438,2,2,4,6,85,20,A6,H1,B8
06_85_38,xcond_1,GRCm39,1845,3375,5575,1842,3372,5572,3,3,3,6,85,38,A6,H1,D2
06_86_06,xcond_1,GRCm39,535,729,1212,535,729,1212,0,0,0,6,86,6,A6,H2,A6
06_86_15,xcond_1,GRCm39,450,589,964,448,586,957,2,3,7,6,86,15,A6,H2,B3
06_86_33,xcond_1,GRCm39,811,1261,2055,810,1260,2054,1,1,1,6,86,33,A6,H2,C9
06_86_86,xcond_1,GRCm39,634,1044,1674,633,1043,1673,1,1,1,6,86,86,A6,H2,H2
06_87_36,xcond_1,GRCm39,221,269,406,220,268,405,1,1,1,6,87,36,A6,H3,C12
06_87_89,xcond_1,GRCm39,765,1182,1758,765,1182,1758,0,0,0,6,87,89,A6,H3,H5
06_88_47,xcond_1,GRCm39,754,1124,1842,753,1123,1841,1,1,1,6,88,47,A6,H4,D11
06_88_79,xcond_1,GRCm39,1402,2291,3666,1400,2288,3659,2,3,7,6,88,79,A6,H4,G7
06_89_23,xcond_1,GRCm39,256,307,470,256,307,470,0,0,0,6,89,23,A6,H5,B11
06_89_29,xcond_1,GRCm39,444,546,859,444,546,859,0,0,0,6,89,29,A6,H5,C5
06_89_38,xcond_1,GRCm39,565,955,1554,565,955,1554,0,0,0,6,89,38,A6,H5,D2
06_89_52,xcond_1,GRCm39,1105,1946,3153,1105,1946,3153,0,0,0,6,89,52,A6,H5,E4
06_89_89,xcond_1,GRCm39,1746,3196,5111,1743,3193,5106,3,3,5,6,89,89,A6,H5,H5
06_89_92,xcond_1,GRCm39,695,1147,1874,695,1147,1874,0,0,0,6,89,92,A6,H5,H8
06_90_21,xcond_1,GRCm39,923,1433,2354,923,1433,2354,0,0,0,6,90,21,A6,H6,B9
06_90_36,xcond_1,GRCm39,1325,2435,3902,1324,2434,3901,1,1,1,6,90,36,A6,H6,C12
06_90_71,xcond_1,GRCm39,743,1169,1878,743,1169,1878,0,0,0,6,90,71,A6,H6,F11
06_90_72,xcond_1,GRCm39,1874,3190,5444,1873,3187,5438,1,3,6,6,90,72,A6,H6,F12
06_90_73,xcond_1,GRCm39,936,1405,2371,935,1404,2370,1,1,1,6,90,73,A6,H6,G1
06_90_81,xcond_1,GRCm39,766,1103,1943,766,1103,1943,0,0,0,6,90,81,A6,H6,G9
06_90_84,xcond_1,GRCm39,1064,1765,2929,1063,1764,2928,1,1,1,6,90,84,A6,H6,G12
06_91_03,xcond_1,GRCm39,1317,2755,4487,1315,2753,4485,2,2,2,6,91,3,A6,H7,A3
06_91_16,xcond_1,GRCm39,457,629,1056,457,629,1056,0,0,0,6,91,16,A6,H7,B4
06_91_29,xcond_1,GRCm39,293,731,1183,293,731,1183,0,0,0,6,91,29,A6,H7,C5
06_91_37,xcond_1,GRCm39,863,1446,2301,862,1445,2300,1,1,1,6,91,37,A6,H7,D1
06_91_41,xcond_1,GRCm39,2131,4580,7413,2130,4579,7411,1,1,2,6,91,41,A6,H7,D5
06_91_45,xcond_1,GRCm39,2250,4686,7632,2245,4679,7625,5,7,7,6,91,45,A6,H7,D9
06_91_66,xcond_1,GRCm39,1361,2488,4147,1360,2486,4144,1,2,3,6,91,66,A6,H7,F6
06_91_69,xcond_1,GRCm39,1226,2094,3340,1225,2093,3338,1,1,2,6,91,69,A6,H7,F9
06_91_84,xcond_1,GRCm39,1502,2978,4898,1500,2975,4894,2,3,4,6,91,84,A6,H7,G12
06_92_04,xcond_1,GRCm39,1585,2864,4727,1583,2862,4725,2,2,2,6,92,4,A6,H8,A4
06_92_14,xcond_1,GRCm39,344,423,665,344,423,665,0,0,0,6,92,14,A6,H8,B2
06_92_18,xcond_1,GRCm39,257,322,543,257,322,543,0,0,0,6,92,18,A6,H8,B6
06_93_20,xcond_1,GRCm39,617,870,1394,617,870,1394,0,0,0,6,93,20,A6,H9,B8
06_93_33,xcond_1,GRCm39,328,427,715,328,427,715,0,0,0,6,93,33,A6,H9,C9
06_93_48,xcond_1,GRCm39,1698,3701,6011,1693,3693,5998,5,8,13,6,93,48,A6,H9,D12
06_93_50,xcond_1,GRCm39,858,1419,2300,857,1417,2296,1,2,4,6,93,50,A6,H9,E2
06_93_61,xcond_1,GRCm39,2126,3986,6448,2123,3980,6441,3,6,7,6,93,61,A6,H9,F1
06_93_74,xcond_1,GRCm39,3803,10210,16736,3799,10206,16732,4,4,4,6,93,74,A6,H9,G2
06_94_02,xcond_1,GRCm39,436,656,1063,434,654,1059,2,2,4,6,94,2,A6,H10,A2
06_94_54,xcond_1,GRCm39,283,332,528,282,331,527,1,1,1,6,94,54,A6,H10,E6
06_94_80,xcond_1,GRCm39,673,971,1595,672,970,1593,1,1,2,6,94,80,A6,H10,G8
06_95_20,xcond_1,GRCm39,807,1198,1969,805,1196,1964,2,2,5,6,95,20,A6,H11,B8
06_95_42,xcond_1,GRCm39,1204,1771,2876,1202,1769,2872,2,2,4,6,95,42,A6,H11,D6
06_96_33,xcond_1,GRCm39,186,217,347,186,217,347,0,0,0,6,96,33,A6,H12,C9
06_96_67,xcond_1,GRCm39,341,436,701,341,436,701,0,0,0,6,96,67,A6,H12,F7
07_01_05,xcond_1,GRCm39,1228,2358,3865,1228,2358,3865,0,0,0,7,1,5,A7,A1,A5
07_01_17,xcond_1,GRCm39,2903,7598,12375,2897,7589,12361,6,9,14,7,1,17,A7,A1,B5
07_01_25,xcond_1,GRCm39,862,1343,2215,862,1343,2215,0,0,0,7,1,25,A7,A1,C1
07_01_33,xcond_1,GRCm39,591,975,1586,590,974,1583,1,1,3,7,1,33,A7,A1,C9
07_02_01,xcond_1,GRCm39,386,509,831,385,508,830,1,1,1,7,2,1,A7,A2,A1
07_02_56,xcond_1,GRCm39,340,448,720,340,448,720,0,0,0,7,2,56,A7,A2,E8
07_02_89,xcond_1,GRCm39,1697,2983,4924,1693,2977,4914,4,6,10,7,2,89,A7,A2,H5
07_02_92,xcond_1,GRCm39,333,430,689,332,429,686,1,1,3,7,2,92,A7,A2,H8
07_02_96,xcond_1,GRCm39,762,1056,1757,762,1056,1757,0,0,0,7,2,96,A7,A2,H12
07_04_08,xcond_1,GRCm39,1649,3152,5319,1648,3151,5316,1,1,3,7,4,8,A7,A4,A8
07_04_11,xcond_1,GRCm39,1831,3821,6405,1829,3819,6403,2,2,2,7,4,11,A7,A4,A11
07_04_89,xcond_1,GRCm39,416,568,985,416,568,985,0,0,0,7,4,89,A7,A4,H5
07_05_44,xcond_1,GRCm39,1207,1924,3136,1207,1924,3136,0,0,0,7,5,44,A7,A5,D8
07_05_45,xcond_1,GRCm39,438,542,902,437,541,901,1,1,1,7,5,45,A7,A5,D9
07_05_48,xcond_1,GRCm39,833,1222,1983,833,1222,1983,0,0,0,7,5,48,A7,A5,D12
07_06_12,xcond_1,GRCm39,524,800,1321,524,800,1321,0,0,0,7,6,12,A7,A6,A12
07_06_13,xcond_1,GRCm39,1377,2705,4422,1375,2702,4417,2,3,5,7,6,13,A7,A6,B1
07_06_72,xcond_1,GRCm39,633,1008,1619,633,1008,1619,0,0,0,7,6,72,A7,A6,F12
07_06_77,xcond_1,GRCm39,969,1696,2865,968,1695,2862,1,1,3,7,6,77,A7,A6,G5
07_08_23,xcond_1,GRCm39,2502,5493,8875,2498,5487,8864,4,6,11,7,8,23,A7,A8,B11
07_08_35,xcond_1,GRCm39,1290,2063,3318,1288,2061,3316,2,2,2,7,8,35,A7,A8,C11
07_08_67,xcond_1,GRCm39,254,344,551,254,344,551,0,0,0,7,8,67,A7,A8,F7
07_08_85,xcond_1,GRCm39,729,1316,2142,728,1314,2140,1,2,2,7,8,85,A7,A8,H1
07_09_36,xcond_1,GRCm39,1880,3379,5240,1876,3375,5236,4,4,4,7,9,36,A7,A9,C12
07_09_49,xcond_1,GRCm39,1078,1832,3053,1077,1829,3048,1,3,5,7,9,49,A7,A9,E1
07_09_72,xcond_1,GRCm39,765,1271,2178,764,1270,2177,1,1,1,7,9,72,A7,A9,F12
07_10_24,xcond_1,GRCm39,280,346,541,279,345,540,1,1,1,7,10,24,A7,A10,B12
07_10_33,xcond_1,GRCm39,537,740,1177,535,738,1175,2,2,2,7,10,33,A7,A10,C9
07_10_72,xcond_1,GRCm39,370,526,850,369,525,847,1,1,3,7,10,72,A7,A10,F12
07_10_79,xcond_1,GRCm39,265,378,577,265,378,577,0,0,0,7,10,79,A7,A10,G7
07_10_84,xcond_1,GRCm39,1325,2625,4366,1324,2624,4365,1,1,1,7,10,84,A7,A10,G12
07_10_86,xcond_1,GRCm39,4224,12634,20952,4218,12624,20936,6,10,16,7,10,86,A7,A10,H2
07_11_92,xcond_1,GRCm39,492,616,980,492,616,980,0,0,0,7,11,92,A7,A11,H8
07_12_07,xcond_1,GRCm39,1091,1877,3075,1090,1874,3069,1,3,6,7,12,7,A7,A12,A7
07_12_19,xcond_1,GRCm39,511,873,1389,511,873,1389,0,0,0,7,12,19,A7,A12,B7
07_12_54,xcond_1,GRCm39,1178,2654,4359,1176,2651,4354,2,3,5,7,12,54,A7,A12,E6
07_12_69,xcond_1,GRCm39,294,370,581,294,370,581,0,0,0,7,12,69,A7,A12,F9
07_13_09,xcond_1,GRCm39,1472,2555,4229,1470,2552,4225,2,3,4,7,13,9,A7,B1,A9
07_13_44,xcond_1,GRCm39,221,307,511,221,307,511,0,0,0,7,13,44,A7,B1,D8
07_13_77,xcond_1,GRCm39,594,857,1420,593,856,1417,1,1,3,7,13,77,A7,B1,G5
07_13_78,xcond_1,GRCm39,554,717,1218,553,716,1214,1,1,4,7,13,78,A7,B1,G6
07_14_16,xcond_1,GRCm39,1031,1554,2603,1029,1552,2600,2,2,3,7,14,16,A7,B2,B4
07_14_89,xcond_1,GRCm39,2532,5343,8859,2529,5339,8854,3,4,5,7,14,89,A7,B2,H5
07_15_29,xcond_1,GRCm39,999,1476,2404,997,1474,2399,2,2,5,7,15,29,A7,B3,C5
07_15_76,xcond_1,GRCm39,481,621,1059,481,621,1059,0,0,0,7,15,76,A7,B3,G4
07_15_96,xcond_1,GRCm39,636,962,1642,635,961,1641,1,1,1,7,15,96,A7,B3,H12
07_16_19,xcond_1,GRCm39,328,465,764,328,465,764,0,0,0,7,16,19,A7,B4,B7
07_16_35,xcond_1,GRCm39,549,774,1274,549,774,1274,0,0,0,7,16,35,A7,B4,C11
07_16_64,xcond_1,GRCm39,295,384,579,295,384,579,0,0,0,7,16,64,A7,B4,F4
07_16_75,xcond_1,GRCm39,357,501,840,355,499,838,2,2,2,7,16,75,A7,B4,G3
07_16_78,xcond_1,GRCm39,1065,1746,2913,1065,1746,2913,0,0,0,7,16,78,A7,B4,G6
07_17_19,xcond_1,GRCm39,739,1377,2231,737,1375,2225,2,2,6,7,17,19,A7,B5,B7
07_17_73,xcond_1,GRCm39,1791,3082,5136,1788,3079,5130,3,3,6,7,17,73,A7,B5,G1
07_17_75,xcond_1,GRCm39,1160,1986,3236,1158,1984,3234,2,2,2,7,17,75,A7,B5,G3
07_17_84,xcond_1,GRCm39,892,1458,2442,891,1457,2441,1,1,1,7,17,84,A7,B5,G12
07_18_03,xcond_1,GRCm39,721,1016,1671,718,1013,1667,3,3,4,7,18,3,A7,B6,A3
07_18_09,xcond_1,GRCm39,460,712,1225,460,712,1225,0,0,0,7,18,9,A7,B6,A9
07_18_56,xcond_1,GRCm39,544,763,1247,543,762,1246,1,1,1,7,18,56,A7,B6,E8
07_18_84,xcond_1,GRCm39,570,749,1211,569,748,1210,1,1,1,7,18,84,A7,B6,G12
07_18_85,xcond_1,GRCm39,934,1519,2493,931,1515,2485,3,4,8,7,18,85,A7,B6,H1
07_19_12,xcond_1,GRCm39,359,523,881,359,523,881,0,0,0,7,19,12,A7,B7,A12
07_19_86,xcond_1,GRCm39,487,654,1062,487,654,1062,0,0,0,7,19,86,A7,B7,H2
07_20_38,xcond_1,GRCm39,606,1048,1654,606,1048,1654,0,0,0,7,20,38,A7,B8,D2
07_20_59,xcond_1,GRCm39,404,501,773,404,501,773,0,0,0,7,20,59,A7,B8,E11
07_20_69,xcond_1,GRCm39,443,606,973,443,606,973,0,0,0,7,20,69,A7,B8,F9
07_20_72,xcond_1,GRCm39,704,1204,2041,704,1204,2041,0,0,0,7,20,72,A7,B8,F12
07_20_96,xcond_1,GRCm39,1110,1837,2916,1110,1837,2916,0,0,0,7,20,96,A7,B8,H12
07_21_17,xcond_1,GRCm39,220,277,446,220,277,446,0,0,0,7,21,17,A7,B9,B5
07_21_30,xcond_1,GRCm39,754,1323,2189,752,1320,2186,2,3,3,7,21,30,A7,B9,C6
07_21_73,xcond_1,GRCm39,444,603,952,443,602,951,1,1,1,7,21,73,A7,B9,G1
07_22_42,xcond_1,GRCm39,2143,4284,7206,2141,4280,7200,2,4,6,7,22,42,A7,B10,D6
07_23_13,xcond_1,GRCm39,501,686,1049,500,685,1047,1,1,2,7,23,13,A7,B11,B1
07_23_14,xcond_1,GRCm39,471,712,1154,471,712,1154,0,0,0,7,23,14,A7,B11,B2
07_23_18,xcond_1,GRCm39,979,1546,2507,978,1545,2505,1,1,2,7,23,18,A7,B11,B6
07_23_36,xcond_1,GRCm39,513,749,1138,512,748,1137,1,1,1,7,23,36,A7,B11,C12
07_23_68,xcond_1,GRCm39,1021,1515,2430,1020,1514,2429,1,1,1,7,23,68,A7,B11,F8
07_24_44,xcond_1,GRCm39,421,939,1537,421,939,1537,0,0,0,7,24,44,A7,B12,D8
07_24_84,xcond_1,GRCm39,1634,3466,5776,1633,3465,5775,1,1,1,7,24,84,A7,B12,G12
07_24_87,xcond_1,GRCm39,2048,4128,6948,2044,4122,6939,4,6,9,7,24,87,A7,B12,H3
07_25_20,xcond_1,GRCm39,570,865,1388,569,864,1387,1,1,1,7,25,20,A7,C1,B8
07_26_29,xcond_1,GRCm39,841,1310,2135,841,1310,2135,0,0,0,7,26,29,A7,C2,C5
07_26_83,xcond_1,GRCm39,485,639,1048,484,638,1046,1,1,2,7,26,83,A7,C2,G11
07_27_07,xcond_1,GRCm39,786,1168,1848,785,1166,1845,1,2,3,7,27,7,A7,C3,A7
07_27_27,xcond_1,GRCm39,711,1333,2092,710,1332,2091,1,1,1,7,27,27,A7,C3,C3
07_27_32,xcond_1,GRCm39,449,676,1126,448,675,1125,1,1,1,7,27,32,A7,C3,C8
07_27_49,xcond_1,GRCm39,525,704,1235,525,704,1235,0,0,0,7,27,49,A7,C3,E1
07_28_16,xcond_1,GRCm39,427,558,925,426,557,924,1,1,1,7,28,16,A7,C4,B4
07_29_14,xcond_1,GRCm39,396,579,993,395,577,991,1,2,2,7,29,14,A7,C5,B2
07_29_42,xcond_1,GRCm39,1073,1777,2950,1071,1773,2945,2,4,5,7,29,42,A7,C5,D6
07_29_54,xcond_1,GRCm39,651,1038,1671,651,1038,1671,0,0,0,7,29,54,A7,C5,E6
07_29_67,xcond_1,GRCm39,419,577,906,419,577,906,0,0,0,7,29,67,A7,C5,F7
07_29_72,xcond_1,GRCm39,1208,2053,3515,1207,2052,3514,1,1,1,7,29,72,A7,C5,F12
07_29_73,xcond_1,GRCm39,636,919,1566,636,919,1566,0,0,0,7,29,73,A7,C5,G1
07_30_30,xcond_1,GRCm39,1102,1826,3002,1101,1824,2998,1,2,4,7,30,30,A7,C6,C6
07_30_63,xcond_1,GRCm39,247,330,528,247,330,528,0,0,0,7,30,63,A7,C6,F3
07_30_77,xcond_1,GRCm39,440,662,1103,439,661,1102,1,1,1,7,30,77,A7,C6,G5
07_30_86,xcond_1,GRCm39,1998,3840,6276,1995,3835,6271,3,5,5,7,30,86,A7,C6,H2
07_31_26,xcond_1,GRCm39,776,1093,1757,776,1093,1757,0,0,0,7,31,26,A7,C7,C2
07_31_31,xcond_1,GRCm39,423,582,971,421,580,969,2,2,2,7,31,31,A7,C7,C7
07_31_48,xcond_1,GRCm39,978,1607,2709,977,1606,2706,1,1,3,7,31,48,A7,C7,D12
07_31_57,xcond_1,GRCm39,420,639,1061,420,639,1061,0,0,0,7,31,57,A7,C7,E9
07_31_69,xcond_1,GRCm39,700,1170,1939,699,1169,1938,1,1,1,7,31,69,A7,C7,F9
07_31_87,xcond_1,GRCm39,2315,4482,7331,2307,4470,7317,8,12,14,7,31,87,A7,C7,H3
07_31_89,xcond_1,GRCm39,617,882,1402,615,880,1399,2,2,3,7,31,89,A7,C7,H5
07_31_96,xcond_1,GRCm39,301,445,704,300,444,702,1,1,2,7,31,96,A7,C7,H12
07_32_09,xcond_1,GRCm39,400,585,960,400,585,960,0,0,0,7,32,9,A7,C8,A9
07_32_21,xcond_1,GRCm39,399,515,872,399,515,872,0,0,0,7,32,21,A7,C8,B9
07_32_45,xcond_1,GRCm39,407,625,1021,407,625,1021,0,0,0,7,32,45,A7,C8,D9
07_32_60,xcond_1,GRCm39,946,1637,2710,945,1636,2708,1,1,2,7,32,60,A7,C8,E12
07_32_84,xcond_1,GRCm39,202,265,419,202,265,419,0,0,0,7,32,84,A7,C8,G12
07_33_36,xcond_1,GRCm39,753,1322,2140,753,1322,2140,0,0,0,7,33,36,A7,C9,C12
07_33_61,xcond_1,GRCm39,636,866,1413,636,866,1413,0,0,0,7,33,61,A7,C9,F1
07_33_79,xcond_1,GRCm39,838,1266,2062,838,1266,2062,0,0,0,7,33,79,A7,C9,G7
07_33_96,xcond_1,GRCm39,1759,3701,5997,1758,3700,5994,1,1,3,7,33,96,A7,C9,H12
07_34_32,xcond_1,GRCm39,602,956,1534,601,955,1533,1,1,1,7,34,32,A7,C10,C8
07_34_33,xcond_1,GRCm39,508,736,1229,507,735,1228,1,1,1,7,34,33,A7,C10,C9
07_34_72,xcond_1,GRCm39,738,1406,2295,736,1402,2291,2,4,4,7,34,72,A7,C10,F12
07_34_76,xcond_1,GRCm39,212,258,435,212,258,435,0,0,0,7,34,76,A7,C10,G4
07_35_76,xcond_1,GRCm39,357,451,713,357,451,713,0,0,0,7,35,76,A7,C11,G4
07_35_84,xcond_1,GRCm39,1450,2511,4048,1449,2510,4047,1,1,1,7,35,84,A7,C11,G12
07_36_18,xcond_1,GRCm39,1076,1605,2628,1073,1601,2622,3,4,6,7,36,18,A7,C12,B6
07_36_52,xcond_1,GRCm39,358,480,730,356,478,726,2,2,4,7,36,52,A7,C12,E4
07_36_71,xcond_1,GRCm39,832,1357,2213,829,1353,2208,3,4,5,7,36,71,A7,C12,F11
07_37_11,xcond_1,GRCm39,437,625,972,435,622,969,2,3,3,7,37,11,A7,D1,A11
07_37_37,xcond_1,GRCm39,1720,3868,6592,1717,3865,6589,3,3,3,7,37,37,A7,D1,D1
07_37_40,xcond_1,GRCm39,636,982,1670,636,982,1670,0,0,0,7,37,40,A7,D1,D4
07_37_60,xcond_1,GRCm39,438,576,947,438,576,947,0,0,0,7,37,60,A7,D1,E12
07_37_68,xcond_1,GRCm39,615,861,1441,614,860,1437,1,1,4,7,37,68,A7,D1,F8
07_37_88,xcond_1,GRCm39,434,600,1006,432,597,1003,2,3,3,7,37,88,A7,D1,H4
07_38_09,xcond_1,GRCm39,320,406,710,320,406,710,0,0,0,7,38,9,A7,D2,A9
07_38_68,xcond_1,GRCm39,1229,2147,3577,1228,2146,3576,1,1,1,7,38,68,A7,D2,F8
07_39_68,xcond_1,GRCm39,678,1006,1589,677,1005,1585,1,1,4,7,39,68,A7,D3,F8
07_40_14,xcond_1,GRCm39,635,983,1644,634,982,1643,1,1,1,7,40,14,A7,D4,B2
07_40_19,xcond_1,GRCm39,1733,3309,5445,1731,3306,5441,2,3,4,7,40,19,A7,D4,B7
07_40_40,xcond_1,GRCm39,508,703,1166,506,699,1161,2,4,5,7,40,40,A7,D4,D4
07_40_53,xcond_1,GRCm39,1084,1748,2886,1082,1746,2881,2,2,5,7,40,53,A7,D4,E5
07_40_56,xcond_1,GRCm39,623,902,1515,622,901,1512,1,1,3,7,40,56,A7,D4,E8
07_40_57,xcond_1,GRCm39,781,1196,2022,780,1195,2021,1,1,1,7,40,57,A7,D4,E9
07_40_69,xcond_1,GRCm39,331,471,748,331,471,748,0,0,0,7,40,69,A7,D4,F9
07_41_06,xcond_1,GRCm39,1079,1972,3263,1078,1971,3262,1,1,1,7,41,6,A7,D5,A6
07_41_38,xcond_1,GRCm39,353,444,734,353,444,734,0,0,0,7,41,38,A7,D5,D2
07_41_83,xcond_1,GRCm39,520,742,1234,519,739,1225,1,3,9,7,41,83,A7,D5,G11
07_42_01,xcond_1,GRCm39,981,1887,3034,979,1885,3031,2,2,3,7,42,1,A7,D6,A1
07_42_53,xcond_1,GRCm39,188,226,333,188,226,333,0,0,0,7,42,53,A7,D6,E5
07_42_72,xcond_1,GRCm39,1545,2685,4495,1543,2682,4492,2,3,3,7,42,72,A7,D6,F12
07_42_77,xcond_1,GRCm39,1000,1516,2495,999,1515,2494,1,1,1,7,42,77,A7,D6,G5
07_42_87,xcond_1,GRCm39,1076,1934,3106,1073,1930,3100,3,4,6,7,42,87,A7,D6,H3
07_42_92,xcond_1,GRCm39,332,427,707,332,427,707,0,0,0,7,42,92,A7,D6,H8
07_43_13,xcond_1,GRCm39,554,781,1243,552,779,1241,2,2,2,7,43,13,A7,D7,B1
07_43_96,xcond_1,GRCm39,366,442,718,366,442,718,0,0,0,7,43,96,A7,D7,H12
07_44_05,xcond_1,GRCm39,230,608,950,230,608,950,0,0,0,7,44,5,A7,D8,A5
07_44_15,xcond_1,GRCm39,1274,2532,4069,1273,2531,4068,1,1,1,7,44,15,A7,D8,B3
07_44_56,xcond_1,GRCm39,1762,3375,5502,1761,3374,5501,1,1,1,7,44,56,A7,D8,E8
07_44_63,xcond_1,GRCm39,1247,2348,3761,1247,2348,3761,0,0,0,7,44,63,A7,D8,F3
07_45_35,xcond_1,GRCm39,574,917,1501,574,917,1501,0,0,0,7,45,35,A7,D9,C11
07_45_37,xcond_1,GRCm39,1170,2059,3421,1168,2056,3416,2,3,5,7,45,37,A7,D9,D1
07_45_78,xcond_1,GRCm39,775,1213,2055,775,1213,2055,0,0,0,7,45,78,A7,D9,G6
07_46_29,xcond_1,GRCm39,568,865,1388,567,864,1387,1,1,1,7,46,29,A7,D10,C5
07_46_45,xcond_1,GRCm39,312,442,741,312,442,741,0,0,0,7,46,45,A7,D10,D9
07_46_52,xcond_1,GRCm39,710,1031,1771,708,1029,1768,2,2,3,7,46,52,A7,D10,E4
07_46_65,xcond_1,GRCm39,932,1705,2859,931,1704,2858,1,1,1,7,46,65,A7,D10,F5
07_47_24,xcond_1,GRCm39,706,1297,2131,705,1296,2129,1,1,2,7,47,24,A7,D11,B12
07_47_55,xcond_1,GRCm39,916,1572,2486,914,1570,2484,2,2,2,7,47,55,A7,D11,E7
07_48_03,xcond_1,GRCm39,318,485,767,318,485,767,0,0,0,7,48,3,A7,D12,A3
07_48_04,xcond_1,GRCm39,415,607,976,415,607,976,0,0,0,7,48,4,A7,D12,A4
07_48_07,xcond_1,GRCm39,971,1479,2431,970,1478,2430,1,1,1,7,48,7,A7,D12,A7
07_48_29,xcond_1,GRCm39,674,1059,1775,672,1057,1773,2,2,2,7,48,29,A7,D12,C5
07_48_43,xcond_1,GRCm39,488,696,1190,488,696,1190,0,0,0,7,48,43,A7,D12,D7
07_48_64,xcond_1,GRCm39,587,815,1398,586,814,1397,1,1,1,7,48,64,A7,D12,F4
07_49_11,xcond_1,GRCm39,476,747,1247,475,746,1244,1,1,3,7,49,11,A7,E1,A11
07_49_14,xcond_1,GRCm39,2115,4969,8285,2111,4962,8276,4,7,9,7,49,14,A7,E1,B2
07_49_37,xcond_1,GRCm39,311,416,691,311,416,691,0,0,0,7,49,37,A7,E1,D1
07_49_47,xcond_1,GRCm39,373,486,836,373,486,836,0,0,0,7,49,47,A7,E1,D11
07_49_51,xcond_1,GRCm39,316,379,627,315,378,625,1,1,2,7,49,51,A7,E1,E3
07_49_54,xcond_1,GRCm39,537,790,1298,535,787,1294,2,3,4,7,49,54,A7,E1,E6
07_50_07,xcond_1,GRCm39,598,1097,1780,597,1096,1779,1,1,1,7,50,7,A7,E2,A7
07_50_11,xcond_1,GRCm39,1149,1815,3024,1148,1814,3023,1,1,1,7,50,11,A7,E2,A11
07_50_42,xcond_1,GRCm39,935,1389,2252,933,1387,2250,2,2,2,7,50,42,A7,E2,D6
07_50_91,xcond_1,GRCm39,473,641,1030,472,640,1026,1,1,4,7,50,91,A7,E2,H7
07_51_05,xcond_1,GRCm39,654,1017,1686,654,1017,1686,0,0,0,7,51,5,A7,E3,A5
07_51_07,xcond_1,GRCm39,420,597,982,419,596,976,1,1,6,7,51,7,A7,E3,A7
07_51_51,xcond_1,GRCm39,345,497,869,344,496,868,1,1,1,7,51,51,A7,E3,E3
07_51_60,xcond_1,GRCm39,319,473,774,319,473,774,0,0,0,7,51,60,A7,E3,E12
07_52_17,xcond_1,GRCm39,204,247,398,204,247,398,0,0,0,7,52,17,A7,E4,B5
07_52_32,xcond_1,GRCm39,939,1350,2192,938,1349,2191,1,1,1,7,52,32,A7,E4,C8
07_52_42,xcond_1,GRCm39,653,958,1628,653,958,1628,0,0,0,7,52,42,A7,E4,D6
07_52_49,xcond_1,GRCm39,691,1068,1827,690,1066,1825,1,2,2,7,52,49,A7,E4,E1
07_52_78,xcond_1,GRCm39,442,696,1134,442,696,1134,0,0,0,7,52,78,A7,E4,G6
07_53_09,xcond_1,GRCm39,642,869,1461,641,868,1460,1,1,1,7,53,9,A7,E5,A9
07_53_59,xcond_1,GRCm39,729,1188,1909,727,1186,1907,2,2,2,7,53,59,A7,E5,E11
07_53_63,xcond_1,GRCm39,1120,1585,2546,1119,1583,2544,1,2,2,7,53,63,A7,E5,F3
07_53_73,xcond_1,GRCm39,811,1513,2451,810,1512,2449,1,1,2,7,53,73,A7,E5,G1
07_54_03,xcond_1,GRCm39,480,799,1359,480,799,1359,0,0,0,7,54,3,A7,E6,A3
07_54_07,xcond_1,GRCm39,500,700,1152,500,700,1152,0,0,0,7,54,7,A7,E6,A7
07_54_09,xcond_1,GRCm39,417,546,898,417,546,898,0,0,0,7,54,9,A7,E6,A9
07_54_35,xcond_1,GRCm39,2120,4326,7228,2118,4323,7223,2,3,5,7,54,35,A7,E6,C11
07_54_76,xcond_1,GRCm39,995,1902,3108,993,1899,3104,2,3,4,7,54,76,A7,E6,G4
07_54_84,xcond_1,GRCm39,964,1655,2829,963,1654,2828,1,1,1,7,54,84,A7,E6,G12
07_55_26,xcond_1,GRCm39,259,332,545,259,332,545,0,0,0,7,55,26,A7,E7,C2
07_55_32,xcond_1,GRCm39,377,453,763,375,451,760,2,2,3,7,55,32,A7,E7,C8
07_56_11,xcond_1,GRCm39,975,2051,3350,974,2050,3349,1,1,1,7,56,11,A7,E8,A11
07_56_33,xcond_1,GRCm39,1135,1692,2773,1131,1688,2765,4,4,8,7,56,33,A7,E8,C9
07_56_90,xcond_1,GRCm39,292,429,697,292,429,697,0,0,0,7,56,90,A7,E8,H6
07_57_62,xcond_1,GRCm39,752,1075,1788,752,1075,1788,0,0,0,7,57,62,A7,E9,F2
07_57_64,xcond_1,GRCm39,638,1105,1835,638,1105,1835,0,0,0,7,57,64,A7,E9,F4
07_57_69,xcond_1,GRCm39,837,1497,2506,837,1497,2506,0,0,0,7,57,69,A7,E9,F9
07_57_77,xcond_1,GRCm39,491,662,1094,491,662,1094,0,0,0,7,57,77,A7,E9,G5
07_58_51,xcond_1,GRCm39,1664,3125,5190,1663,3124,5189,1,1,1,7,58,51,A7,E10,E3
07_58_84,xcond_1,GRCm39,162,443,700,162,443,700,0,0,0,7,58,84,A7,E10,G12
07_59_85,xcond_1,GRCm39,457,606,988,455,604,986,2,2,2,7,59,85,A7,E11,H1
07_60_73,xcond_1,GRCm39,1054,1801,3049,1051,1796,3040,3,5,9,7,60,73,A7,E12,G1
07_61_24,xcond_1,GRCm39,609,1060,1715,608,1059,1713,1,1,2,7,61,24,A7,F1,B12
07_61_31,xcond_1,GRCm39,1641,2795,4601,1640,2794,4600,1,1,1,7,61,31,A7,F1,C7
07_61_76,xcond_1,GRCm39,426,608,945,425,607,944,1,1,1,7,61,76,A7,F1,G4
07_62_36,xcond_1,GRCm39,79,344,502,79,344,502,0,0,0,7,62,36,A7,F2,C12
07_62_42,xcond_1,GRCm39,1626,3454,5785,1621,3449,5771,5,5,14,7,62,42,A7,F2,D6
07_62_55,xcond_1,GRCm39,562,818,1354,560,816,1351,2,2,3,7,62,55,A7,F2,E7
07_63_20,xcond_1,GRCm39,837,1395,2298,837,1395,2298,0,0,0,7,63,20,A7,F3,B8
07_63_23,xcond_1,GRCm39,671,966,1686,670,965,1685,1,1,1,7,63,23,A7,F3,B11
07_63_57,xcond_1,GRCm39,849,1255,2070,849,1255,2070,0,0,0,7,63,57,A7,F3,E9
07_63_95,xcond_1,GRCm39,420,562,931,420,562,931,0,0,0,7,63,95,A7,F3,H11
07_64_31,xcond_1,GRCm39,582,928,1611,580,926,1607,2,2,4,7,64,31,A7,F4,C7
07_64_33,xcond_1,GRCm39,221,304,543,220,303,541,1,1,2,7,64,33,A7,F4,C9
07_64_42,xcond_1,GRCm39,805,1319,2209,804,1318,2208,1,1,1,7,64,42,A7,F4,D6
07_64_45,xcond_1,GRCm39,534,750,1265,533,749,1263,1,1,2,7,64,45,A7,F4,D9
07_64_51,xcond_1,GRCm39,472,595,1033,472,595,1033,0,0,0,7,64,51,A7,F4,E3
07_64_54,xcond_1,GRCm39,835,1488,2542,834,1487,2541,1,1,1,7,64,54,A7,F4,E6
07_64_86,xcond_1,GRCm39,1560,2706,4517,1558,2702,4510,2,4,7,7,64,86,A7,F4,H2
07_65_07,xcond_1,GRCm39,514,891,1552,514,891,1552,0,0,0,7,65,7,A7,F5,A7
07_65_24,xcond_1,GRCm39,620,1075,1860,619,1074,1859,1,1,1,7,65,24,A7,F5,B12
07_65_69,xcond_1,GRCm39,1223,2052,3477,1220,2048,3472,3,4,5,7,65,69,A7,F5,F9
07_67_78,xcond_1,GRCm39,616,929,1539,615,928,1538,1,1,1,7,67,78,A7,F7,G6
07_68_15,xcond_1,GRCm39,3948,11093,18481,3942,11083,18467,6,10,14,7,68,15,A7,F8,B3
07_68_17,xcond_1,GRCm39,341,429,670,341,429,670,0,0,0,7,68,17,A7,F8,B5
07_68_23,xcond_1,GRCm39,952,1667,2695,950,1665,2693,2,2,2,7,68,23,A7,F8,B11
07_68_53,xcond_1,GRCm39,1212,2114,3658,1211,2111,3653,1,3,5,7,68,53,A7,F8,E5
07_69_13,xcond_1,GRCm39,636,1085,1759,634,1082,1752,2,3,7,7,69,13,A7,F9,B1
07_70_60,xcond_1,GRCm39,602,926,1546,597,918,1534,5,8,12,7,70,60,A7,F10,E12
07_71_21,xcond_1,GRCm39,661,1026,1623,661,1026,1623,0,0,0,7,71,21,A7,F11,B9
07_71_23,xcond_1,GRCm39,1008,1875,3057,1007,1874,3055,1,1,2,7,71,23,A7,F11,B11
07_71_49,xcond_1,GRCm39,1152,1931,3161,1151,1930,3160,1,1,1,7,71,49,A7,F11,E1
07_71_60,xcond_1,GRCm39,274,363,627,272,361,625,2,2,2,7,71,60,A7,F11,E12
07_72_29,xcond_1,GRCm39,477,769,1252,477,769,1252,0,0,0,7,72,29,A7,F12,C5
07_72_30,xcond_1,GRCm39,943,2545,4245,940,2542,4241,3,3,4,7,72,30,A7,F12,C6
07_73_07,xcond_1,GRCm39,573,847,1377,571,845,1375,2,2,2,7,73,7,A7,G1,A7
07_73_17,xcond_1,GRCm39,928,1676,2722,927,1675,2721,1,1,1,7,73,17,A7,G1,B5
07_73_38,xcond_1,GRCm39,1365,2393,3966,1363,2390,3961,2,3,5,7,73,38,A7,G1,D2
07_73_48,xcond_1,GRCm39,440,598,1013,439,597,1010,1,1,3,7,73,48,A7,G1,D12
07_73_87,xcond_1,GRCm39,404,512,814,404,512,814,0,0,0,7,73,87,A7,G1,H3
07_74_12,xcond_1,GRCm39,1183,1939,3138,1181,1937,3135,2,2,3,7,74,12,A7,G2,A12
07_74_21,xcond_1,GRCm39,972,1798,2949,971,1797,2948,1,1,1,7,74,21,A7,G2,B9
07_74_27,xcond_1,GRCm39,662,994,1566,662,994,1566,0,0,0,7,74,27,A7,G2,C3
07_74_61,xcond_1,GRCm39,605,859,1402,604,858,1400,1,1,2,7,74,61,A7,G2,F1
07_75_43,xcond_1,GRCm39,737,1263,2061,736,1262,2060,1,1,1,7,75,43,A7,G3,D7
07_75_56,xcond_1,GRCm39,467,610,1008,467,610,1008,0,0,0,7,75,56,A7,G3,E8
07_75_72,xcond_1,GRCm39,1387,2700,4545,1387,2700,4545,0,0,0,7,75,72,A7,G3,F12
07_75_84,xcond_1,GRCm39,667,951,1563,665,949,1560,2,2,3,7,75,84,A7,G3,G12
07_76_21,xcond_1,GRCm39,367,456,762,367,456,762,0,0,0,7,76,21,A7,G4,B9
07_76_40,xcond_1,GRCm39,676,953,1598,676,953,1598,0,0,0,7,76,40,A7,G4,D4
07_76_63,xcond_1,GRCm39,1562,3052,5066,1561,3051,5065,1,1,1,7,76,63,A7,G4,F3
07_76_69,xcond_1,GRCm39,291,372,616,291,372,616,0,0,0,7,76,69,A7,G4,F9
07_77_53,xcond_1,GRCm39,316,476,733,314,474,730,2,2,3,7,77,53,A7,G5,E5
07_77_64,xcond_1,GRCm39,1150,1794,2905,1148,1791,2900,2,3,5,7,77,64,A7,G5,F4
07_78_02,xcond_1,GRCm39,676,915,1545,676,915,1545,0,0,0,7,78,2,A7,G6,A2
07_78_12,xcond_1,GRCm39,704,1180,1979,703,1179,1978,1,1,1,7,78,12,A7,G6,A12
07_78_78,xcond_1,GRCm39,1281,2129,3611,1280,2128,3610,1,1,1,7,78,78,A7,G6,G6
07_79_09,xcond_1,GRCm39,309,374,644,309,374,644,0,0,0,7,79,9,A7,G7,A9
07_79_29,xcond_1,GRCm39,2389,5589,9355,2385,5584,9346,4,5,9,7,79,29,A7,G7,C5
07_79_35,xcond_1,GRCm39,1130,2142,3552,1129,2141,3551,1,1,1,7,79,35,A7,G7,C11
07_79_41,xcond_1,GRCm39,600,864,1446,600,864,1446,0,0,0,7,79,41,A7,G7,D5
07_79_48,xcond_1,GRCm39,133,277,448,133,277,448,0,0,0,7,79,48,A7,G7,D12
07_79_68,xcond_1,GRCm39,499,805,1371,498,804,1370,1,1,1,7,79,68,A7,G7,F8
07_79_90,xcond_1,GRCm39,548,807,1332,546,805,1329,2,2,3,7,79,90,A7,G7,H6
07_80_12,xcond_1,GRCm39,2860,6354,10636,2851,6341,10617,9,13,19,7,80,12,A7,G8,A12
07_80_55,xcond_1,GRCm39,306,416,673,306,416,673,0,0,0,7,80,55,A7,G8,E7
07_80_60,xcond_1,GRCm39,496,762,1291,495,761,1290,1,1,1,7,80,60,A7,G8,E12
07_80_84,xcond_1,GRCm39,355,439,670,355,439,670,0,0,0,7,80,84,A7,G8,G12
07_81_07,xcond_1,GRCm39,402,533,911,400,531,908,2,2,3,7,81,7,A7,G9,A7
07_81_19,xcond_1,GRCm39,859,1258,2066,859,1258,2066,0,0,0,7,81,19,A7,G9,B7
07_81_45,xcond_1,GRCm39,675,1051,1742,674,1050,1740,1,1,2,7,81,45,A7,G9,D9
07_82_40,xcond_1,GRCm39,468,642,1073,467,641,1072,1,1,1,7,82,40,A7,G10,D4
07_83_02,xcond_1,GRCm39,178,235,387,178,235,387,0,0,0,7,83,2,A7,G11,A2
07_83_41,xcond_1,GRCm39,213,279,462,213,279,462,0,0,0,7,83,41,A7,G11,D5
07_83_51,xcond_1,GRCm39,179,225,376,178,224,375,1,1,1,7,83,51,A7,G11,E3
07_83_81,xcond_1,GRCm39,333,505,803,333,505,803,0,0,0,7,83,81,A7,G11,G9
07_84_68,xcond_1,GRCm39,703,992,1603,702,989,1599,1,3,4,7,84,68,A7,G12,F8
07_85_09,xcond_1,GRCm39,197,261,386,197,261,386,0,0,0,7,85,9,A7,H1,A9
07_85_19,xcond_1,GRCm39,2693,6074,9761,2691,6068,9753,2,6,8,7,85,19,A7,H1,B7
07_85_20,xcond_1,GRCm39,350,442,705,348,440,702,2,2,3,7,85,20,A7,H1,B8
07_85_28,xcond_1,GRCm39,400,608,954,399,607,953,1,1,1,7,85,28,A7,H1,C4
07_85_42,xcond_1,GRCm39,254,583,889,254,583,889,0,0,0,7,85,42,A7,H1,D6
07_85_86,xcond_1,GRCm39,840,1687,2691,839,1685,2689,1,2,2,7,85,86,A7,H1,H2
07_86_08,xcond_1,GRCm39,916,1683,2854,914,1681,2852,2,2,2,7,86,8,A7,H2,A8
07_86_52,xcond_1,GRCm39,1430,2355,3888,1429,2353,3885,1,2,3,7,86,52,A7,H2,E4
07_86_55,xcond_1,GRCm39,1166,2026,3291,1165,2025,3290,1,1,1,7,86,55,A7,H2,E7
07_86_56,xcond_1,GRCm39,2130,4626,7683,2128,4624,7679,2,2,4,7,86,56,A7,H2,E8
07_86_57,xcond_1,GRCm39,335,491,770,334,490,768,1,1,2,7,86,57,A7,H2,E9
07_87_25,xcond_1,GRCm39,1017,1887,2944,1016,1886,2943,1,1,1,7,87,25,A7,H3,C1
07_87_95,xcond_1,GRCm39,769,1373,2211,769,1373,2211,0,0,0,7,87,95,A7,H3,H11
07_88_21,xcond_1,GRCm39,716,1201,1873,715,1199,1871,1,2,2,7,88,21,A7,H4,B9
07_88_26,xcond_1,GRCm39,344,532,848,343,531,847,1,1,1,7,88,26,A7,H4,C2
07_88_31,xcond_1,GRCm39,209,265,441,209,265,441,0,0,0,7,88,31,A7,H4,C7
07_88_78,xcond_1,GRCm39,950,1646,2636,950,1646,2636,0,0,0,7,88,78,A7,H4,G6
07_89_19,xcond_1,GRCm39,813,1116,1757,812,1115,1756,1,1,1,7,89,19,A7,H5,B7
07_89_35,xcond_1,GRCm39,378,568,946,378,568,946,0,0,0,7,89,35,A7,H5,C11
07_89_36,xcond_1,GRCm39,1017,1543,2409,1015,1541,2405,2,2,4,7,89,36,A7,H5,C12
07_89_67,xcond_1,GRCm39,890,1367,2215,888,1363,2210,2,4,5,7,89,67,A7,H5,F7
07_90_27,xcond_1,GRCm39,518,817,1325,517,816,1323,1,1,2,7,90,27,A7,H6,C3
07_90_55,xcond_1,GRCm39,772,1041,1790,772,1041,1790,0,0,0,7,90,55,A7,H6,E7
07_91_36,xcond_1,GRCm39,522,700,1141,522,700,1141,0,0,0,7,91,36,A7,H7,C12
07_91_42,xcond_1,GRCm39,1036,2116,3441,1035,2115,3439,1,1,2,7,91,42,A7,H7,D6
07_91_65,xcond_1,GRCm39,671,1198,2017,670,1197,2016,1,1,1,7,91,65,A7,H7,F5
07_91_76,xcond_1,GRCm39,429,627,1053,429,627,1053,0,0,0,7,91,76,A7,H7,G4
07_91_91,xcond_1,GRCm39,1160,1955,3276,1157,1952,3272,3,3,4,7,91,91,A7,H7,H7
07_92_04,xcond_1,GRCm39,478,623,1059,478,623,1059,0,0,0,7,92,4,A7,H8,A4
07_92_41,xcond_1,GRCm39,847,1297,2120,845,1294,2115,2,3,5,7,92,41,A7,H8,D5
07_92_49,xcond_1,GRCm39,499,785,1302,499,785,1302,0,0,0,7,92,49,A7,H8,E1
07_92_56,xcond_1,GRCm39,199,249,425,199,249,425,0,0,0,7,92,56,A7,H8,E8
07_92_61,xcond_1,GRCm39,564,976,1591,564,976,1591,0,0,0,7,92,61,A7,H8,F1
07_93_07,xcond_1,GRCm39,1596,2850,4665,1595,2849,4664,1,1,1,7,93,7,A7,H9,A7
07_93_32,xcond_1,GRCm39,731,1101,1813,731,1101,1813,0,0,0,7,93,32,A7,H9,C8
07_93_60,xcond_1,GRCm39,596,874,1467,594,872,1464,2,2,3,7,93,60,A7,H9,E12
07_93_73,xcond_1,GRCm39,1817,3354,5476,1815,3352,5472,2,2,4,7,93,73,A7,H9,G1
07_93_74,xcond_1,GRCm39,959,1659,2754,956,1656,2750,3,3,4,7,93,74,A7,H9,G2
07_93_84,xcond_1,GRCm39,2851,7290,12149,2848,7287,12143,3,3,6,7,93,84,A7,H9,G12
07_93_86,xcond_1,GRCm39,350,566,895,350,566,895,0,0,0,7,93,86,A7,H9,H2
07_94_06,xcond_1,GRCm39,499,665,1091,498,664,1090,1,1,1,7,94,6,A7,H10,A6
07_94_26,xcond_1,GRCm39,325,409,659,325,409,659,0,0,0,7,94,26,A7,H10,C2
07_94_59,xcond_1,GRCm39,349,514,834,349,514,834,0,0,0,7,94,59,A7,H10,E11
08_01_25,xcond_1,GRCm39,712,1054,1748,712,1054,1748,0,0,0,8,1,25,A8,A1,C1
08_02_89,xcond_1,GRCm39,400,561,939,400,561,939,0,0,0,8,2,89,A8,A2,H5
08_02_96,xcond_1,GRCm39,1343,2516,4169,1341,2514,4166,2,2,3,8,2,96,A8,A2,H12
08_03_07,xcond_1,GRCm39,504,731,1151,502,729,1149,2,2,2,8,3,7,A8,A3,A7
08_03_44,xcond_1,GRCm39,592,840,1357,591,839,1353,1,1,4,8,3,44,A8,A3,D8
08_03_52,xcond_1,GRCm39,806,1236,1973,804,1234,1971,2,2,2,8,3,52,A8,A3,E4
08_04_33,xcond_1,GRCm39,309,465,771,309,465,771,0,0,0,8,4,33,A8,A4,C9
08_05_18,xcond_1,GRCm39,724,1162,1850,722,1159,1846,2,3,4,8,5,18,A8,A5,B6
08_05_47,xcond_1,GRCm39,298,378,625,298,378,625,0,0,0,8,5,47,A8,A5,D11
08_05_77,xcond_1,GRCm39,508,704,1159,507,702,1157,1,2,2,8,5,77,A8,A5,G5
08_06_11,xcond_1,GRCm39,564,822,1317,564,822,1317,0,0,0,8,6,11,A8,A6,A11
08_06_48,xcond_1,GRCm39,524,661,1089,524,661,1089,0,0,0,8,6,48,A8,A6,D12
08_06_91,xcond_1,GRCm39,631,945,1511,629,943,1508,2,2,3,8,6,91,A8,A6,H7
08_06_96,xcond_1,GRCm39,2636,5363,8709,2629,5354,8699,7,9,10,8,6,96,A8,A6,H12
08_07_30,xcond_1,GRCm39,950,1531,2469,948,1528,2466,2,3,3,8,7,30,A8,A7,C6
08_07_45,xcond_1,GRCm39,468,595,997,468,595,997,0,0,0,8,7,45,A8,A7,D9
08_07_59,xcond_1,GRCm39,833,1236,2025,831,1234,2022,2,2,3,8,7,59,A8,A7,E11
08_07_72,xcond_1,GRCm39,541,728,1234,539,726,1232,2,2,2,8,7,72,A8,A7,F12
08_08_14,xcond_1,GRCm39,259,306,498,259,306,498,0,0,0,8,8,14,A8,A8,B2
08_08_16,xcond_1,GRCm39,1138,1840,3027,1138,1840,3027,0,0,0,8,8,16,A8,A8,B4
08_08_23,xcond_1,GRCm39,366,492,775,366,492,775,0,0,0,8,8,23,A8,A8,B11
08_08_83,xcond_1,GRCm39,290,356,631,289,355,630,1,1,1,8,8,83,A8,A8,G11
08_08_93,xcond_1,GRCm39,553,770,1203,552,769,1201,1,1,2,8,8,93,A8,A8,H9
08_09_04,xcond_1,GRCm39,1011,1952,3189,1009,1950,3187,2,2,2,8,9,4,A8,A9,A4
08_09_06,xcond_1,GRCm39,308,453,763,307,452,760,1,1,3,8,9,6,A8,A9,A6
08_09_76,xcond_1,GRCm39,541,786,1312,540,785,1311,1,1,1,8,9,76,A8,A9,G4
08_10_19,xcond_1,GRCm39,1171,1777,2818,1167,1773,2814,4,4,4,8,10,19,A8,A10,B7
08_10_73,xcond_1,GRCm39,499,709,1199,499,709,1199,0,0,0,8,10,73,A8,A10,G1
08_10_81,xcond_1,GRCm39,228,299,490,227,297,487,1,2,3,8,10,81,A8,A10,G9
08_10_84,xcond_1,GRCm39,569,815,1364,568,813,1362,1,2,2,8,10,84,A8,A10,G12
08_12_03,xcond_1,GRCm39,558,760,1241,557,759,1240,1,1,1,8,12,3,A8,A12,A3
08_12_09,xcond_1,GRCm39,216,298,509,216,298,509,0,0,0,8,12,9,A8,A12,A9
08_12_38,xcond_1,GRCm39,440,653,1104,440,653,1104,0,0,0,8,12,38,A8,A12,D2
08_12_40,xcond_1,GRCm39,668,1058,1725,667,1057,1724,1,1,1,8,12,40,A8,A12,D4
08_12_86,xcond_1,GRCm39,266,314,492,266,314,492,0,0,0,8,12,86,A8,A12,H2
08_13_15,xcond_1,GRCm39,733,1178,1900,732,1177,1899,1,1,1,8,13,15,A8,B1,B3
08_13_24,xcond_1,GRCm39,596,913,1528,594,911,1525,2,2,3,8,13,24,A8,B1,B12
08_14_74,xcond_1,GRCm39,781,1464,2434,781,1464,2434,0,0,0,8,14,74,A8,B2,G2
08_15_12,xcond_1,GRCm39,536,711,1151,536,711,1151,0,0,0,8,15,12,A8,B3,A12
08_15_32,xcond_1,GRCm39,877,1355,2222,876,1354,2221,1,1,1,8,15,32,A8,B3,C8
08_15_60,xcond_1,GRCm39,520,680,1040,519,679,1038,1,1,2,8,15,60,A8,B3,E12
08_15_90,xcond_1,GRCm39,1507,2783,4575,1505,2779,4568,2,4,7,8,15,90,A8,B3,H6
08_16_64,xcond_1,GRCm39,185,226,329,185,226,329,0,0,0,8,16,64,A8,B4,F4
08_17_11,xcond_1,GRCm39,951,1387,2305,949,1385,2303,2,2,2,8,17,11,A8,B5,A11
08_17_15,xcond_1,GRCm39,564,866,1372,564,866,1372,0,0,0,8,17,15,A8,B5,B3
08_17_32,xcond_1,GRCm39,433,590,965,432,589,964,1,1,1,8,17,32,A8,B5,C8
08_17_50,xcond_1,GRCm39,195,315,515,195,315,515,0,0,0,8,17,50,A8,B5,E2
08_17_53,xcond_1,GRCm39,702,1116,1926,701,1115,1925,1,1,1,8,17,53,A8,B5,E5
08_18_03,xcond_1,GRCm39,2358,4219,7023,2355,4216,7019,3,3,4,8,18,3,A8,B6,A3
08_18_14,xcond_1,GRCm39,730,1256,2043,729,1255,2039,1,1,4,8,18,14,A8,B6,B2
08_19_17,xcond_1,GRCm39,460,609,961,459,608,960,1,1,1,8,19,17,A8,B7,B5
08_19_47,xcond_1,GRCm39,440,589,976,439,588,975,1,1,1,8,19,47,A8,B7,D11
08_19_54,xcond_1,GRCm39,362,584,929,361,583,928,1,1,1,8,19,54,A8,B7,E6
08_20_30,xcond_1,GRCm39,271,734,1164,271,734,1164,0,0,0,8,20,30,A8,B8,C6
08_20_72,xcond_1,GRCm39,555,951,1501,555,951,1501,0,0,0,8,20,72,A8,B8,F12
08_20_79,xcond_1,GRCm39,855,1281,2061,853,1279,2059,2,2,2,8,20,79,A8,B8,G7
08_20_91,xcond_1,GRCm39,416,563,900,415,562,899,1,1,1,8,20,91,A8,B8,H7
08_22_88,xcond_1,GRCm39,935,1392,2301,933,1390,2298,2,2,3,8,22,88,A8,B10,H4
08_23_96,xcond_1,GRCm39,738,1216,1935,738,1216,1935,0,0,0,8,23,96,A8,B11,H12
08_24_45,xcond_1,GRCm39,339,441,738,339,441,738,0,0,0,8,24,45,A8,B12,D9
08_25_17,xcond_1,GRCm39,109,225,354,107,223,351,2,2,3,8,25,17,A8,C1,B5
08_25_31,xcond_1,GRCm39,412,542,902,411,541,901,1,1,1,8,25,31,A8,C1,C7
08_26_17,xcond_1,GRCm39,317,422,714,317,422,714,0,0,0,8,26,17,A8,C2,B5
08_27_16,xcond_1,GRCm39,606,1153,1870,606,1153,1870,0,0,0,8,27,16,A8,C3,B4
08_27_42,xcond_1,GRCm39,655,1272,2042,655,1272,2042,0,0,0,8,27,42,A8,C3,D6
08_28_03,xcond_1,GRCm39,612,860,1417,610,857,1414,2,3,3,8,28,3,A8,C4,A3
08_28_21,xcond_1,GRCm39,377,494,818,376,493,817,1,1,1,8,28,21,A8,C4,B9
08_28_29,xcond_1,GRCm39,1609,2825,4542,1608,2824,4541,1,1,1,8,28,29,A8,C4,C5
08_29_95,xcond_1,GRCm39,493,705,1174,492,704,1173,1,1,1,8,29,95,A8,C5,H11
08_30_01,xcond_1,GRCm39,269,337,523,269,337,523,0,0,0,8,30,1,A8,C6,A1
08_30_45,xcond_1,GRCm39,153,210,346,152,209,345,1,1,1,8,30,45,A8,C6,D9
08_30_77,xcond_1,GRCm39,389,508,826,388,507,825,1,1,1,8,30,77,A8,C6,G5
08_31_32,xcond_1,GRCm39,179,213,325,179,213,325,0,0,0,8,31,32,A8,C7,C8
08_31_44,xcond_1,GRCm39,577,860,1356,576,859,1355,1,1,1,8,31,44,A8,C7,D8
08_31_72,xcond_1,GRCm39,780,1258,2087,780,1258,2087,0,0,0,8,31,72,A8,C7,F12
08_31_95,xcond_1,GRCm39,1488,2420,3965,1486,2417,3961,2,3,4,8,31,95,A8,C7,H11
08_32_66,xcond_1,GRCm39,242,348,537,242,348,537,0,0,0,8,32,66,A8,C8,F6
08_33_44,xcond_1,GRCm39,326,433,702,325,432,700,1,1,2,8,33,44,A8,C9,D8
08_33_69,xcond_1,GRCm39,347,455,738,345,453,735,2,2,3,8,33,69,A8,C9,F9
08_34_66,xcond_1,GRCm39,504,661,1029,503,660,1027,1,1,2,8,34,66,A8,C10,F6
08_35_26,xcond_1,GRCm39,323,415,689,323,415,689,0,0,0,8,35,26,A8,C11,C2
08_35_81,xcond_1,GRCm39,398,506,825,397,505,822,1,1,3,8,35,81,A8,C11,G9
08_36_09,xcond_1,GRCm39,232,309,491,232,309,491,0,0,0,8,36,9,A8,C12,A9
08_36_52,xcond_1,GRCm39,264,336,490,264,336,490,0,0,0,8,36,52,A8,C12,E4
08_36_71,xcond_1,GRCm39,319,386,643,319,386,643,0,0,0,8,36,71,A8,C12,F11
08_37_40,xcond_1,GRCm39,2074,3768,6237,2070,3763,6229,4,5,8,8,37,40,A8,D1,D4
08_38_06,xcond_1,GRCm39,360,468,789,358,466,787,2,2,2,8,38,6,A8,D2,A6
08_38_32,xcond_1,GRCm39,1620,2656,4432,1619,2655,4431,1,1,1,8,38,32,A8,D2,C8
08_39_33,xcond_1,GRCm39,579,829,1318,579,829,1318,0,0,0,8,39,33,A8,D3,C9
08_39_39,xcond_1,GRCm39,449,560,915,449,560,915,0,0,0,8,39,39,A8,D3,D3
08_39_57,xcond_1,GRCm39,217,265,415,216,264,413,1,1,2,8,39,57,A8,D3,E9
08_39_76,xcond_1,GRCm39,342,481,776,342,481,776,0,0,0,8,39,76,A8,D3,G4
08_40_59,xcond_1,GRCm39,545,822,1359,545,822,1359,0,0,0,8,40,59,A8,D4,E11
08_40_86,xcond_1,GRCm39,638,924,1565,638,924,1565,0,0,0,8,40,86,A8,D4,H2
08_41_28,xcond_1,GRCm39,412,532,883,411,531,882,1,1,1,8,41,28,A8,D5,C4
08_41_89,xcond_1,GRCm39,1121,2087,3387,1118,2084,3383,3,3,4,8,41,89,A8,D5,H5
08_42_77,xcond_1,GRCm39,133,213,350,133,213,350,0,0,0,8,42,77,A8,D6,G5
08_42_88,xcond_1,GRCm39,622,914,1522,621,913,1521,1,1,1,8,42,88,A8,D6,H4
08_44_21,xcond_1,GRCm39,290,382,633,290,382,633,0,0,0,8,44,21,A8,D8,B9
08_44_48,xcond_1,GRCm39,813,1125,1826,813,1125,1826,0,0,0,8,44,48,A8,D8,D12
08_44_72,xcond_1,GRCm39,184,372,616,184,372,616,0,0,0,8,44,72,A8,D8,F12
08_45_11,xcond_1,GRCm39,117,220,372,116,219,370,1,1,2,8,45,11,A8,D9,A11
08_45_12,xcond_1,GRCm39,407,560,905,406,559,901,1,1,4,8,45,12,A8,D9,A12
08_45_40,xcond_1,GRCm39,669,1078,1768,668,1077,1765,1,1,3,8,45,40,A8,D9,D4
08_45_87,xcond_1,GRCm39,655,1012,1709,655,1012,1709,0,0,0,8,45,87,A8,D9,H3
08_46_32,xcond_1,GRCm39,669,1084,1781,669,1084,1781,0,0,0,8,46,32,A8,D10,C8
08_46_33,xcond_1,GRCm39,256,317,515,255,316,511,1,1,4,8,46,33,A8,D10,C9
08_46_51,xcond_1,GRCm39,690,1028,1708,689,1025,1705,1,3,3,8,46,51,A8,D10,E3
08_46_74,xcond_1,GRCm39,802,1303,2169,802,1303,2169,0,0,0,8,46,74,A8,D10,G2
08_46_93,xcond_1,GRCm39,322,444,727,322,444,727,0,0,0,8,46,93,A8,D10,H9
08_46_95,xcond_1,GRCm39,729,1154,1883,728,1153,1882,1,1,1,8,46,95,A8,D10,H11
08_47_31,xcond_1,GRCm39,1191,1743,2827,1190,1742,2826,1,1,1,8,47,31,A8,D11,C7
08_47_43,xcond_1,GRCm39,1084,1802,2939,1083,1801,2937,1,1,2,8,47,43,A8,D11,D7
08_48_26,xcond_1,GRCm39,624,852,1340,624,852,1340,0,0,0,8,48,26,A8,D12,C2
08_48_59,xcond_1,GRCm39,419,582,921,418,581,920,1,1,1,8,48,59,A8,D12,E11
08_49_13,xcond_1,GRCm39,893,1291,2147,893,1291,2147,0,0,0,8,49,13,A8,E1,B1
08_49_68,xcond_1,GRCm39,766,1120,1838,766,1120,1838,0,0,0,8,49,68,A8,E1,F8
08_49_81,xcond_1,GRCm39,201,233,380,201,233,380,0,0,0,8,49,81,A8,E1,G9
08_50_65,xcond_1,GRCm39,70,278,432,70,278,432,0,0,0,8,50,65,A8,E2,F5
08_51_28,xcond_1,GRCm39,474,602,1011,474,602,1011,0,0,0,8,51,28,A8,E3,C4
08_52_05,xcond_1,GRCm39,452,604,1064,451,603,1063,1,1,1,8,52,5,A8,E4,A5
08_52_15,xcond_1,GRCm39,1213,2029,3278,1210,2024,3271,3,5,7,8,52,15,A8,E4,B3
08_52_72,xcond_1,GRCm39,643,985,1643,642,984,1641,1,1,2,8,52,72,A8,E4,F12
08_52_81,xcond_1,GRCm39,273,343,579,273,343,579,0,0,0,8,52,81,A8,E4,G9
08_52_89,xcond_1,GRCm39,348,474,775,348,474,775,0,0,0,8,52,89,A8,E4,H5
08_52_90,xcond_1,GRCm39,512,724,1220,512,724,1220,0,0,0,8,52,90,A8,E4,H6
08_53_39,xcond_1,GRCm39,1646,3014,4876,1645,3013,4875,1,1,1,8,53,39,A8,E5,D3
08_53_41,xcond_1,GRCm39,308,381,623,307,380,621,1,1,2,8,53,41,A8,E5,D5
08_53_77,xcond_1,GRCm39,388,578,965,387,577,964,1,1,1,8,53,77,A8,E5,G5
08_54_49,xcond_1,GRCm39,674,942,1605,674,942,1605,0,0,0,8,54,49,A8,E6,E1
08_54_50,xcond_1,GRCm39,708,1022,1723,706,1018,1718,2,4,5,8,54,50,A8,E6,E2
08_54_53,xcond_1,GRCm39,1259,2009,3312,1256,2006,3309,3,3,3,8,54,53,A8,E6,E5
08_54_55,xcond_1,GRCm39,284,347,575,284,347,575,0,0,0,8,54,55,A8,E6,E7
08_54_79,xcond_1,GRCm39,968,1484,2375,968,1484,2375,0,0,0,8,54,79,A8,E6,G7
08_55_05,xcond_1,GRCm39,236,273,463,236,273,463,0,0,0,8,55,5,A8,E7,A5
08_55_20,xcond_1,GRCm39,434,582,942,434,582,942,0,0,0,8,55,20,A8,E7,B8
08_55_24,xcond_1,GRCm39,315,407,635,315,407,635,0,0,0,8,55,24,A8,E7,B12
08_55_26,xcond_1,GRCm39,256,350,550,256,350,550,0,0,0,8,55,26,A8,E7,C2
08_55_88,xcond_1,GRCm39,503,731,1245,503,731,1245,0,0,0,8,55,88,A8,E7,H4
08_56_30,xcond_1,GRCm39,662,917,1515,662,917,1515,0,0,0,8,56,30,A8,E8,C6
08_56_54,xcond_1,GRCm39,381,475,788,381,475,788,0,0,0,8,56,54,A8,E8,E6
08_57_20,xcond_1,GRCm39,3362,8648,14198,3357,8643,14192,5,5,6,8,57,20,A8,E9,B8
08_57_31,xcond_1,GRCm39,748,1195,1990,748,1195,1990,0,0,0,8,57,31,A8,E9,C7
08_57_38,xcond_1,GRCm39,462,607,996,460,605,992,2,2,4,8,57,38,A8,E9,D2
08_57_39,xcond_1,GRCm39,384,486,811,384,486,811,0,0,0,8,57,39,A8,E9,D3
08_57_54,xcond_1,GRCm39,748,1185,1962,746,1183,1960,2,2,2,8,57,54,A8,E9,E6
08_58_42,xcond_1,GRCm39,1138,1892,3160,1137,1891,3159,1,1,1,8,58,42,A8,E10,D6
08_58_57,xcond_1,GRCm39,237,401,660,237,401,660,0,0,0,8,58,57,A8,E10,E9
08_59_03,xcond_1,GRCm39,1445,2748,4508,1443,2746,4504,2,2,4,8,59,3,A8,E11,A3
08_59_14,xcond_1,GRCm39,831,1399,2237,830,1398,2236,1,1,1,8,59,14,A8,E11,B2
08_59_15,xcond_1,GRCm39,347,801,1340,347,801,1340,0,0,0,8,59,15,A8,E11,B3
08_59_45,xcond_1,GRCm39,415,605,992,415,605,992,0,0,0,8,59,45,A8,E11,D9
08_60_29,xcond_1,GRCm39,647,974,1630,645,972,1624,2,2,6,8,60,29,A8,E12,C5
08_60_59,xcond_1,GRCm39,383,534,869,383,534,869,0,0,0,8,60,59,A8,E12,E11
08_60_61,xcond_1,GRCm39,622,1357,2219,622,1357,2219,0,0,0,8,60,61,A8,E12,F1
08_60_93,xcond_1,GRCm39,762,1052,1777,762,1052,1777,0,0,0,8,60,93,A8,E12,H9
08_61_26,xcond_1,GRCm39,816,1174,1959,816,1174,1959,0,0,0,8,61,26,A8,F1,C2
08_61_28,xcond_1,GRCm39,794,1306,2119,794,1306,2119,0,0,0,8,61,28,A8,F1,C4
08_61_81,xcond_1,GRCm39,307,385,601,307,385,601,0,0,0,8,61,81,A8,F1,G9
08_62_32,xcond_1,GRCm39,1600,2783,4690,1598,2778,4680,2,5,10,8,62,32,A8,F2,C8
08_62_53,xcond_1,GRCm39,340,450,757,340,450,757,0,0,0,8,62,53,A8,F2,E5
08_62_87,xcond_1,GRCm39,452,572,919,452,572,919,0,0,0,8,62,87,A8,F2,H3
08_63_15,xcond_1,GRCm39,90,230,375,90,230,375,0,0,0,8,63,15,A8,F3,B3
08_63_25,xcond_1,GRCm39,383,528,873,382,527,872,1,1,1,8,63,25,A8,F3,C1
08_63_68,xcond_1,GRCm39,742,1154,1955,740,1149,1947,2,5,8,8,63,68,A8,F3,F8
08_63_73,xcond_1,GRCm39,727,1244,2015,726,1243,2014,1,1,1,8,63,73,A8,F3,G1
08_63_79,xcond_1,GRCm39,673,1073,1716,672,1072,1715,1,1,1,8,63,79,A8,F3,G7
08_63_85,xcond_1,GRCm39,222,252,415,222,252,415,0,0,0,8,63,85,A8,F3,H1
08_64_28,xcond_1,GRCm39,511,747,1262,509,745,1259,2,2,3,8,64,28,A8,F4,C4
08_65_18,xcond_1,GRCm39,700,1105,1847,699,1104,1845,1,1,2,8,65,18,A8,F5,B6
08_65_36,xcond_1,GRCm39,558,795,1334,557,794,1333,1,1,1,8,65,36,A8,F5,C12
08_65_39,xcond_1,GRCm39,196,228,378,196,228,378,0,0,0,8,65,39,A8,F5,D3
08_65_41,xcond_1,GRCm39,2091,4388,7314,2090,4387,7313,1,1,1,8,65,41,A8,F5,D5
08_65_63,xcond_1,GRCm39,742,1117,1843,742,1117,1843,0,0,0,8,65,63,A8,F5,F3
08_66_20,xcond_1,GRCm39,939,1543,2615,939,1543,2615,0,0,0,8,66,20,A8,F6,B8
08_66_41,xcond_1,GRCm39,488,694,1198,486,692,1194,2,2,4,8,66,41,A8,F6,D5
08_66_80,xcond_1,GRCm39,470,594,1035,469,593,1034,1,1,1,8,66,80,A8,F6,G8
08_67_15,xcond_1,GRCm39,978,1700,2901,976,1697,2895,2,3,6,8,67,15,A8,F7,B3
08_67_35,xcond_1,GRCm39,263,332,568,262,331,567,1,1,1,8,67,35,A8,F7,C11
08_67_63,xcond_1,GRCm39,336,432,706,336,432,706,0,0,0,8,67,63,A8,F7,F3
08_67_72,xcond_1,GRCm39,386,487,826,385,486,825,1,1,1,8,67,72,A8,F7,F12
08_67_78,xcond_1,GRCm39,391,528,864,390,527,863,1,1,1,8,67,78,A8,F7,G6
08_68_09,xcond_1,GRCm39,187,282,454,187,282,454,0,0,0,8,68,9,A8,F8,A9
08_68_42,xcond_1,GRCm39,2367,4867,7929,2364,4859,7914,3,8,15,8,68,42,A8,F8,D6
08_68_57,xcond_1,GRCm39,957,1474,2390,956,1473,2389,1,1,1,8,68,57,A8,F8,E9
08_69_08,xcond_1,GRCm39,508,750,1223,507,749,1222,1,1,1,8,69,8,A8,F9,A8
08_69_09,xcond_1,GRCm39,207,243,393,206,242,392,1,1,1,8,69,9,A8,F9,A9
08_69_16,xcond_1,GRCm39,469,623,1009,469,623,1009,0,0,0,8,69,16,A8,F9,B4
08_70_25,xcond_1,GRCm39,269,333,550,268,332,549,1,1,1,8,70,25,A8,F10,C1
08_70_35,xcond_1,GRCm39,887,1550,2525,886,1549,2524,1,1,1,8,70,35,A8,F10,C11
08_70_56,xcond_1,GRCm39,333,401,655,333,401,655,0,0,0,8,70,56,A8,F10,E8
08_70_62,xcond_1,GRCm39,526,831,1373,526,831,1373,0,0,0,8,70,62,A8,F10,F2
08_71_67,xcond_1,GRCm39,1300,2083,3363,1298,2081,3359,2,2,4,8,71,67,A8,F11,F7
08_71_73,xcond_1,GRCm39,721,1060,1689,720,1059,1688,1,1,1,8,71,73,A8,F11,G1
08_71_96,xcond_1,GRCm39,278,367,646,278,367,646,0,0,0,8,71,96,A8,F11,H12
08_72_44,xcond_1,GRCm39,799,1323,2124,799,1323,2124,0,0,0,8,72,44,A8,F12,D8
08_73_09,xcond_1,GRCm39,508,705,1180,508,705,1180,0,0,0,8,73,9,A8,G1,A9
08_73_41,xcond_1,GRCm39,538,854,1393,538,854,1393,0,0,0,8,73,41,A8,G1,D5
08_74_16,xcond_1,GRCm39,2935,7338,11944,2931,7334,11939,4,4,5,8,74,16,A8,G2,B4
08_74_56,xcond_1,GRCm39,442,587,932,441,586,931,1,1,1,8,74,56,A8,G2,E8
08_75_13,xcond_1,GRCm39,709,1075,1778,707,1073,1775,2,2,3,8,75,13,A8,G3,B1
08_75_24,xcond_1,GRCm39,771,1307,2140,770,1306,2139,1,1,1,8,75,24,A8,G3,B12
08_77_50,xcond_1,GRCm39,835,1244,2060,833,1242,2057,2,2,3,8,77,50,A8,G5,E2
08_77_57,xcond_1,GRCm39,523,846,1380,523,846,1380,0,0,0,8,77,57,A8,G5,E9
08_78_25,xcond_1,GRCm39,535,824,1377,535,824,1377,0,0,0,8,78,25,A8,G6,C1
08_78_61,xcond_1,GRCm39,743,1046,1801,743,1046,1801,0,0,0,8,78,61,A8,G6,F1
08_78_91,xcond_1,GRCm39,518,660,1092,518,660,1092,0,0,0,8,78,91,A8,G6,H7
08_79_11,xcond_1,GRCm39,676,1045,1755,675,1044,1752,1,1,3,8,79,11,A8,G7,A11
08_79_28,xcond_1,GRCm39,605,844,1374,605,844,1374,0,0,0,8,79,28,A8,G7,C4
08_79_33,xcond_1,GRCm39,405,537,888,404,536,887,1,1,1,8,79,33,A8,G7,C9
08_79_38,xcond_1,GRCm39,350,454,750,350,454,750,0,0,0,8,79,38,A8,G7,D2
08_79_51,xcond_1,GRCm39,771,1277,2115,771,1277,2115,0,0,0,8,79,51,A8,G7,E3
08_79_63,xcond_1,GRCm39,381,509,793,380,507,790,1,2,3,8,79,63,A8,G7,F3
08_79_65,xcond_1,GRCm39,670,1033,1686,668,1031,1682,2,2,4,8,79,65,A8,G7,F5
08_79_78,xcond_1,GRCm39,1504,2510,4085,1502,2507,4082,2,3,3,8,79,78,A8,G7,G6
08_80_24,xcond_1,GRCm39,765,1315,2162,764,1313,2160,1,2,2,8,80,24,A8,G8,B12
08_80_48,xcond_1,GRCm39,584,813,1316,584,813,1316,0,0,0,8,80,48,A8,G8,D12
08_80_72,xcond_1,GRCm39,880,1656,2811,879,1654,2808,1,2,3,8,80,72,A8,G8,F12
08_81_05,xcond_1,GRCm39,650,931,1540,650,931,1540,0,0,0,8,81,5,A8,G9,A5
08_81_33,xcond_1,GRCm39,282,354,603,282,354,603,0,0,0,8,81,33,A8,G9,C9
08_81_50,xcond_1,GRCm39,540,774,1287,540,774,1287,0,0,0,8,81,50,A8,G9,E2
08_82_06,xcond_1,GRCm39,472,663,1087,472,663,1087,0,0,0,8,82,6,A8,G10,A6
08_82_24,xcond_1,GRCm39,3059,7035,11525,3054,7028,11516,5,7,9,8,82,24,A8,G10,B12
08_82_29,xcond_1,GRCm39,769,1445,2345,769,1445,2345,0,0,0,8,82,29,A8,G10,C5
08_82_32,xcond_1,GRCm39,244,394,636,244,394,636,0,0,0,8,82,32,A8,G10,C8
08_82_72,xcond_1,GRCm39,504,759,1280,504,759,1280,0,0,0,8,82,72,A8,G10,F12
08_82_77,xcond_1,GRCm39,725,1129,1835,723,1127,1831,2,2,4,8,82,77,A8,G10,G5
08_83_76,xcond_1,GRCm39,275,360,563,275,360,563,0,0,0,8,83,76,A8,G11,G4
08_83_80,xcond_1,GRCm39,251,300,479,251,300,479,0,0,0,8,83,80,A8,G11,G8
08_83_89,xcond_1,GRCm39,381,544,872,381,544,872,0,0,0,8,83,89,A8,G11,H5
08_83_95,xcond_1,GRCm39,382,542,913,380,539,909,2,3,4,8,83,95,A8,G11,H11
08_84_66,xcond_1,GRCm39,1673,2953,4788,1670,2950,4781,3,3,7,8,84,66,A8,G12,F6
08_85_50,xcond_1,GRCm39,491,696,1181,491,696,1181,0,0,0,8,85,50,A8,H1,E2
08_86_04,xcond_1,GRCm39,841,1312,2196,839,1310,2194,2,2,2,8,86,4,A8,H2,A4
08_86_66,xcond_1,GRCm39,553,803,1320,553,803,1320,0,0,0,8,86,66,A8,H2,F6
08_86_67,xcond_1,GRCm39,946,1533,2476,945,1532,2475,1,1,1,8,86,67,A8,H2,F7
08_87_03,xcond_1,GRCm39,544,759,1225,542,757,1221,2,2,4,8,87,3,A8,H3,A3
08_87_20,xcond_1,GRCm39,503,739,1189,501,737,1187,2,2,2,8,87,20,A8,H3,B8
08_87_60,xcond_1,GRCm39,360,469,747,359,468,746,1,1,1,8,87,60,A8,H3,E12
08_87_72,xcond_1,GRCm39,1295,2151,3575,1294,2149,3573,1,2,2,8,87,72,A8,H3,F12
08_88_09,xcond_1,GRCm39,214,257,399,214,257,399,0,0,0,8,88,9,A8,H4,A9
08_88_52,xcond_1,GRCm39,545,970,1557,545,970,1557,0,0,0,8,88,52,A8,H4,E4
08_89_36,xcond_1,GRCm39,253,369,607,253,369,607,0,0,0,8,89,36,A8,H5,C12
08_89_43,xcond_1,GRCm39,431,564,924,429,562,921,2,2,3,8,89,43,A8,H5,D7
08_89_45,xcond_1,GRCm39,568,830,1409,567,829,1408,1,1,1,8,89,45,A8,H5,D9
08_90_26,xcond_1,GRCm39,506,794,1377,505,793,1374,1,1,3,8,90,26,A8,H6,C2
08_90_71,xcond_1,GRCm39,1494,2986,5063,1491,2983,5059,3,3,4,8,90,71,A8,H6,F11
08_90_96,xcond_1,GRCm39,1815,3288,5675,1812,3285,5668,3,3,7,8,90,96,A8,H6,H12
08_91_02,xcond_1,GRCm39,427,583,974,427,583,974,0,0,0,8,91,2,A8,H7,A2
08_91_40,xcond_1,GRCm39,757,1507,2445,757,1507,2445,0,0,0,8,91,40,A8,H7,D4
08_91_48,xcond_1,GRCm39,440,592,976,440,592,976,0,0,0,8,91,48,A8,H7,D12
08_92_24,xcond_1,GRCm39,619,932,1522,619,932,1522,0,0,0,8,92,24,A8,H8,B12
08_92_26,xcond_1,GRCm39,224,299,505,224,299,505,0,0,0,8,92,26,A8,H8,C2
08_92_61,xcond_1,GRCm39,404,603,996,403,602,995,1,1,1,8,92,61,A8,H8,F1
08_92_95,xcond_1,GRCm39,149,245,393,148,244,390,1,1,3,8,92,95,A8,H8,H11
08_93_25,xcond_1,GRCm39,527,822,1290,526,821,1288,1,1,2,8,93,25,A8,H9,C1
08_93_51,xcond_1,GRCm39,642,968,1639,640,966,1637,2,2,2,8,93,51,A8,H9,E3
08_93_69,xcond_1,GRCm39,462,625,988,462,625,988,0,0,0,8,93,69,A8,H9,F9
08_93_92,xcond_1,GRCm39,894,1354,2224,894,1354,2224,0,0,0,8,93,92,A8,H9,H8
08_94_24,xcond_1,GRCm39,431,844,1421,431,844,1421,0,0,0,8,94,24,A8,H10,B12
08_94_27,xcond_1,GRCm39,476,671,1053,476,671,1053,0,0,0,8,94,27,A8,H10,C3
08_94_85,xcond_1,GRCm39,362,484,789,361,482,787,1,2,2,8,94,85,A8,H10,H1
08_94_96,xcond_1,GRCm39,1313,2363,3946,1313,2363,3946,0,0,0,8,94,96,A8,H10,H12
08_95_05,xcond_1,GRCm39,814,1152,1976,814,1152,1976,0,0,0,8,95,5,A8,H11,A5
08_95_38,xcond_1,GRCm39,380,477,763,379,475,758,1,2,5,8,95,38,A8,H11,D2
08_95_85,xcond_1,GRCm39,416,553,943,415,552,942,1,1,1,8,95,85,A8,H11,H1
08_96_26,xcond_1,GRCm39,386,497,833,385,496,832,1,1,1,8,96,26,A8,H12,C2
08_96_91,xcond_1,GRCm39,453,660,1094,452,659,1093,1,1,1,8,96,91,A8,H12,H7
09_01_21,xcond_1,GRCm39,420,613,998,420,613,998,0,0,0,9,1,21,A9,A1,B9
09_01_48,xcond_1,GRCm39,662,1071,1734,660,1068,1730,2,3,4,9,1,48,A9,A1,D12
09_01_53,xcond_1,GRCm39,1298,2043,3298,1298,2043,3298,0,0,0,9,1,53,A9,A1,E5
09_01_57,xcond_1,GRCm39,189,327,502,189,327,502,0,0,0,9,1,57,A9,A1,E9
09_01_68,xcond_1,GRCm39,825,1305,2091,825,1305,2091,0,0,0,9,1,68,A9,A1,F8
09_01_92,xcond_1,GRCm39,706,1085,1756,705,1083,1751,1,2,5,9,1,92,A9,A1,H8
09_01_93,xcond_1,GRCm39,397,518,810,397,518,810,0,0,0,9,1,93,A9,A1,H9
09_02_38,xcond_1,GRCm39,715,998,1601,714,997,1600,1,1,1,9,2,38,A9,A2,D2
09_02_43,xcond_1,GRCm39,1277,1898,3073,1275,1894,3067,2,4,6,9,2,43,A9,A2,D7
09_02_55,xcond_1,GRCm39,376,491,802,376,491,802,0,0,0,9,2,55,A9,A2,E7
09_03_42,xcond_1,GRCm39,587,856,1379,586,855,1378,1,1,1,9,3,42,A9,A3,D6
09_03_83,xcond_1,GRCm39,1052,1730,2809,1051,1729,2808,1,1,1,9,3,83,A9,A3,G11
09_04_38,xcond_1,GRCm39,181,341,532,180,340,531,1,1,1,9,4,38,A9,A4,D2
09_04_55,xcond_1,GRCm39,1254,2058,3278,1251,2054,3273,3,4,5,9,4,55,A9,A4,E7
09_04_65,xcond_1,GRCm39,1489,2521,4025,1488,2520,4024,1,1,1,9,4,65,A9,A4,F5
09_05_36,xcond_1,GRCm39,591,900,1436,590,899,1435,1,1,1,9,5,36,A9,A5,C12
09_05_43,xcond_1,GRCm39,570,771,1232,570,771,1232,0,0,0,9,5,43,A9,A5,D7
09_05_45,xcond_1,GRCm39,1262,2112,3348,1258,2108,3344,4,4,4,9,5,45,A9,A5,D9
09_05_84,xcond_1,GRCm39,715,1078,1734,713,1076,1732,2,2,2,9,5,84,A9,A5,G12
09_06_05,xcond_1,GRCm39,130,211,312,129,210,311,1,1,1,9,6,5,A9,A6,A5
09_06_57,xcond_1,GRCm39,298,381,632,298,381,632,0,0,0,9,6,57,A9,A6,E9
09_06_77,xcond_1,GRCm39,635,923,1506,632,920,1502,3,3,4,9,6,77,A9,A6,G5
09_06_80,xcond_1,GRCm39,1645,3101,5058,1645,3101,5058,0,0,0,9,6,80,A9,A6,G8
09_07_15,xcond_1,GRCm39,1018,1768,2898,1014,1764,2893,4,4,5,9,7,15,A9,A7,B3
09_07_25,xcond_1,GRCm39,1385,2380,3830,1382,2377,3826,3,3,4,9,7,25,A9,A7,C1
09_07_31,xcond_1,GRCm39,805,1253,1973,804,1252,1972,1,1,1,9,7,31,A9,A7,C7
09_07_35,xcond_1,GRCm39,669,1105,1775,668,1104,1774,1,1,1,9,7,35,A9,A7,C11
09_07_36,xcond_1,GRCm39,426,536,831,425,535,830,1,1,1,9,7,36,A9,A7,C12
09_07_85,xcond_1,GRCm39,1186,2057,3270,1186,2057,3270,0,0,0,9,7,85,A9,A7,H1
09_08_62,xcond_1,GRCm39,643,966,1547,643,966,1547,0,0,0,9,8,62,A9,A8,F2
09_08_66,xcond_1,GRCm39,309,387,652,309,387,652,0,0,0,9,8,66,A9,A8,F6
09_09_19,xcond_1,GRCm39,788,1136,1842,786,1134,1840,2,2,2,9,9,19,A9,A9,B7
09_09_44,xcond_1,GRCm39,680,1142,1886,679,1141,1883,1,1,3,9,9,44,A9,A9,D8
09_10_12,xcond_1,GRCm39,288,366,589,288,366,589,0,0,0,9,10,12,A9,A10,A12
09_10_41,xcond_1,GRCm39,402,596,926,401,595,925,1,1,1,9,10,41,A9,A10,D5
09_10_52,xcond_1,GRCm39,594,956,1530,593,955,1528,1,1,2,9,10,52,A9,A10,E4
09_10_54,xcond_1,GRCm39,347,436,740,347,436,740,0,0,0,9,10,54,A9,A10,E6
09_10_84,xcond_1,GRCm39,467,662,1122,467,662,1122,0,0,0,9,10,84,A9,A10,G12
09_11_25,xcond_1,GRCm39,466,644,1002,466,644,1002,0,0,0,9,11,25,A9,A11,C1
09_11_60,xcond_1,GRCm39,1326,2226,3465,1325,2225,3464,1,1,1,9,11,60,A9,A11,E12
09_12_48,xcond_1,GRCm39,337,490,777,336,489,776,1,1,1,9,12,48,A9,A12,D12
09_12_57,xcond_1,GRCm39,229,312,503,228,311,502,1,1,1,9,12,57,A9,A12,E9
09_12_74,xcond_1,GRCm39,630,1081,1768,628,1079,1766,2,2,2,9,12,74,A9,A12,G2
09_12_93,xcond_1,GRCm39,518,742,1203,517,741,1202,1,1,1,9,12,93,A9,A12,H9
09_13_69,xcond_1,GRCm39,483,723,1179,482,722,1177,1,1,2,9,13,69,A9,B1,F9
09_14_36,xcond_1,GRCm39,1082,1579,2581,1080,1575,2574,2,4,7,9,14,36,A9,B2,C12
09_14_55,xcond_1,GRCm39,559,909,1424,558,908,1423,1,1,1,9,14,55,A9,B2,E7
09_14_60,xcond_1,GRCm39,589,790,1227,588,789,1226,1,1,1,9,14,60,A9,B2,E12
09_14_63,xcond_1,GRCm39,673,916,1442,673,916,1442,0,0,0,9,14,63,A9,B2,F3
09_15_11,xcond_1,GRCm39,425,565,902,423,563,900,2,2,2,9,15,11,A9,B3,A11
09_15_38,xcond_1,GRCm39,806,1177,1824,805,1176,1823,1,1,1,9,15,38,A9,B3,D2
09_15_47,xcond_1,GRCm39,526,830,1242,525,829,1239,1,1,3,9,15,47,A9,B3,D11
09_15_79,xcond_1,GRCm39,1909,3228,5320,1906,3225,5317,3,3,3,9,15,79,A9,B3,G7
09_15_88,xcond_1,GRCm39,724,969,1566,724,969,1566,0,0,0,9,15,88,A9,B3,H4
09_16_29,xcond_1,GRCm39,842,1305,2062,840,1300,2057,2,5,5,9,16,29,A9,B4,C5
09_16_35,xcond_1,GRCm39,677,1113,1802,676,1112,1800,1,1,2,9,16,35,A9,B4,C11
09_16_64,xcond_1,GRCm39,214,258,369,213,257,368,1,1,1,9,16,64,A9,B4,F4
09_16_68,xcond_1,GRCm39,712,1136,1858,711,1134,1854,1,2,4,9,16,68,A9,B4,F8
09_17_13,xcond_1,GRCm39,1821,3242,5400,1816,3237,5394,5,5,6,9,17,13,A9,B5,B1
09_17_24,xcond_1,GRCm39,715,1176,1915,713,1174,1912,2,2,3,9,17,24,A9,B5,B12
09_17_33,xcond_1,GRCm39,138,215,355,138,215,355,0,0,0,9,17,33,A9,B5,C9
09_17_38,xcond_1,GRCm39,978,1488,2419,978,1488,2419,0,0,0,9,17,38,A9,B5,D2
09_17_42,xcond_1,GRCm39,433,603,963,432,602,960,1,1,3,9,17,42,A9,B5,D6
09_17_45,xcond_1,GRCm39,934,1545,2462,932,1542,2453,2,3,9,9,17,45,A9,B5,D9
09_18_08,xcond_1,GRCm39,1357,2504,3991,1356,2503,3990,1,1,1,9,18,8,A9,B6,A8
09_18_20,xcond_1,GRCm39,2952,6322,10205,2948,6315,10186,4,7,19,9,18,20,A9,B6,B8
09_18_24,xcond_1,GRCm39,941,1344,2191,939,1342,2186,2,2,5,9,18,24,A9,B6,B12
09_18_29,xcond_1,GRCm39,504,763,1184,503,762,1183,1,1,1,9,18,29,A9,B6,C5
09_18_67,xcond_1,GRCm39,676,1059,1643,674,1057,1640,2,2,3,9,18,67,A9,B6,F7
09_19_02,xcond_1,GRCm39,1029,1619,2596,1027,1615,2591,2,4,5,9,19,2,A9,B7,A2
09_19_05,xcond_1,GRCm39,1088,1846,2988,1085,1843,2983,3,3,5,9,19,5,A9,B7,A5
09_19_08,xcond_1,GRCm39,1218,1837,2957,1217,1836,2955,1,1,2,9,19,8,A9,B7,A8
09_19_15,xcond_1,GRCm39,573,737,1218,572,736,1217,1,1,1,9,19,15,A9,B7,B3
09_19_55,xcond_1,GRCm39,456,653,1006,456,653,1006,0,0,0,9,19,55,A9,B7,E7
09_19_90,xcond_1,GRCm39,507,694,1131,507,694,1131,0,0,0,9,19,90,A9,B7,H6
09_20_96,xcond_1,GRCm39,746,1106,1773,744,1103,1770,2,3,3,9,20,96,A9,B8,H12
09_21_11,xcond_1,GRCm39,1267,1921,3115,1266,1920,3114,1,1,1,9,21,11,A9,B9,A11
09_21_16,xcond_1,GRCm39,694,1118,1735,692,1116,1732,2,2,3,9,21,16,A9,B9,B4
09_21_36,xcond_1,GRCm39,2399,5002,8053,2395,4994,8039,4,8,14,9,21,36,A9,B9,C12
09_21_42,xcond_1,GRCm39,2380,4621,7596,2378,4617,7592,2,4,4,9,21,42,A9,B9,D6
09_21_84,xcond_1,GRCm39,585,756,1275,583,752,1269,2,4,6,9,21,84,A9,B9,G12
09_21_85,xcond_1,GRCm39,1203,1846,2953,1203,1846,2953,0,0,0,9,21,85,A9,B9,H1
09_21_91,xcond_1,GRCm39,415,1032,1695,414,1031,1694,1,1,1,9,21,91,A9,B9,H7
09_22_02,xcond_1,GRCm39,497,651,1081,497,651,1081,0,0,0,9,22,2,A9,B10,A2
09_22_05,xcond_1,GRCm39,612,915,1424,609,912,1421,3,3,3,9,22,5,A9,B10,A5
09_24_21,xcond_1,GRCm39,776,1033,1674,775,1031,1670,1,2,4,9,24,21,A9,B12,B9
09_24_28,xcond_1,GRCm39,596,825,1332,595,823,1328,1,2,4,9,24,28,A9,B12,C4
09_24_33,xcond_1,GRCm39,107,243,366,106,242,363,1,1,3,9,24,33,A9,B12,C9
09_24_42,xcond_1,GRCm39,853,1275,2042,853,1275,2042,0,0,0,9,24,42,A9,B12,D6
09_24_45,xcond_1,GRCm39,527,657,1048,526,656,1047,1,1,1,9,24,45,A9,B12,D9
09_24_48,xcond_1,GRCm39,468,632,994,468,632,994,0,0,0,9,24,48,A9,B12,D12
09_24_60,xcond_1,GRCm39,404,785,1259,403,784,1258,1,1,1,9,24,60,A9,B12,E12
09_24_69,xcond_1,GRCm39,665,1023,1620,662,1020,1616,3,3,4,9,24,69,A9,B12,F9
09_24_88,xcond_1,GRCm39,380,518,800,379,517,797,1,1,3,9,24,88,A9,B12,H4
09_24_96,xcond_1,GRCm39,946,1777,2809,946,1777,2809,0,0,0,9,24,96,A9,B12,H12
09_25_84,xcond_1,GRCm39,293,371,648,293,371,648,0,0,0,9,25,84,A9,C1,G12
09_25_86,xcond_1,GRCm39,668,963,1583,667,962,1582,1,1,1,9,25,86,A9,C1,H2
09_26_49,xcond_1,GRCm39,584,896,1388,584,896,1388,0,0,0,9,26,49,A9,C2,E1
09_26_55,xcond_1,GRCm39,1144,2000,3241,1143,1999,3240,1,1,1,9,26,55,A9,C2,E7
09_27_06,xcond_1,GRCm39,680,999,1580,679,998,1579,1,1,1,9,27,6,A9,C3,A6
09_27_96,xcond_1,GRCm39,394,515,778,394,515,778,0,0,0,9,27,96,A9,C3,H12
09_28_08,xcond_1,GRCm39,450,599,968,450,599,968,0,0,0,9,28,8,A9,C4,A8
09_28_31,xcond_1,GRCm39,825,1648,2576,822,1644,2569,3,4,7,9,28,31,A9,C4,C7
09_28_59,xcond_1,GRCm39,439,547,929,438,546,928,1,1,1,9,28,59,A9,C4,E11
09_29_04,xcond_1,GRCm39,335,467,783,335,467,783,0,0,0,9,29,4,A9,C5,A4
09_29_21,xcond_1,GRCm39,384,503,808,384,503,808,0,0,0,9,29,21,A9,C5,B9
09_29_23,xcond_1,GRCm39,557,761,1235,557,761,1235,0,0,0,9,29,23,A9,C5,B11
09_29_52,xcond_1,GRCm39,524,810,1267,523,809,1265,1,1,2,9,29,52,A9,C5,E4
09_29_76,xcond_1,GRCm39,543,701,1174,542,700,1173,1,1,1,9,29,76,A9,C5,G4
09_29_81,xcond_1,GRCm39,195,224,348,195,224,348,0,0,0,9,29,81,A9,C5,G9
09_30_08,xcond_1,GRCm39,547,779,1297,547,779,1297,0,0,0,9,30,8,A9,C6,A8
09_30_32,xcond_1,GRCm39,494,635,1007,494,635,1007,0,0,0,9,30,32,A9,C6,C8
09_30_71,xcond_1,GRCm39,364,508,796,364,508,796,0,0,0,9,30,71,A9,C6,F11
09_31_18,xcond_1,GRCm39,501,632,1035,500,631,1034,1,1,1,9,31,18,A9,C7,B6
09_31_35,xcond_1,GRCm39,890,1407,2209,890,1407,2209,0,0,0,9,31,35,A9,C7,C11
09_31_74,xcond_1,GRCm39,726,1258,2020,725,1255,2013,1,3,7,9,31,74,A9,C7,G2
09_31_96,xcond_1,GRCm39,550,802,1239,550,802,1239,0,0,0,9,31,96,A9,C7,H12
09_32_09,xcond_1,GRCm39,236,303,480,236,303,480,0,0,0,9,32,9,A9,C8,A9
09_32_20,xcond_1,GRCm39,416,531,841,416,531,841,0,0,0,9,32,20,A9,C8,B8
09_32_48,xcond_1,GRCm39,496,626,982,495,625,980,1,1,2,9,32,48,A9,C8,D12
09_32_56,xcond_1,GRCm39,349,495,828,348,494,827,1,1,1,9,32,56,A9,C8,E8
09_32_71,xcond_1,GRCm39,206,394,648,204,392,646,2,2,2,9,32,71,A9,C8,F11
09_32_84,xcond_1,GRCm39,1327,2037,3469,1327,2037,3469,0,0,0,9,32,84,A9,C8,G12
09_33_02,xcond_1,GRCm39,454,572,901,454,572,901,0,0,0,9,33,2,A9,C9,A2
09_33_12,xcond_1,GRCm39,933,1517,2476,933,1517,2476,0,0,0,9,33,12,A9,C9,A12
09_33_86,xcond_1,GRCm39,606,931,1490,606,931,1490,0,0,0,9,33,86,A9,C9,H2
09_34_09,xcond_1,GRCm39,179,277,445,178,275,441,1,2,4,9,34,9,A9,C10,A9
09_34_56,xcond_1,GRCm39,474,654,1055,473,653,1054,1,1,1,9,34,56,A9,C10,E8
09_34_57,xcond_1,GRCm39,239,292,445,239,292,445,0,0,0,9,34,57,A9,C10,E9
09_34_72,xcond_1,GRCm39,415,562,917,415,562,917,0,0,0,9,34,72,A9,C10,F12
09_34_93,xcond_1,GRCm39,298,411,684,298,411,684,0,0,0,9,34,93,A9,C10,H9
09_35_60,xcond_1,GRCm39,597,783,1274,597,783,1274,0,0,0,9,35,60,A9,C11,E12
09_35_69,xcond_1,GRCm39,408,607,944,406,605,941,2,2,3,9,35,69,A9,C11,F9
09_36_12,xcond_1,GRCm39,510,775,1229,508,773,1227,2,2,2,9,36,12,A9,C12,A12
09_36_24,xcond_1,GRCm39,1256,2078,3323,1256,2078,3323,0,0,0,9,36,24,A9,C12,B12
09_36_26,xcond_1,GRCm39,326,479,745,325,477,743,1,2,2,9,36,26,A9,C12,C2
09_36_52,xcond_1,GRCm39,265,329,462,265,329,462,0,0,0,9,36,52,A9,C12,E4
09_36_74,xcond_1,GRCm39,689,1013,1570,688,1012,1569,1,1,1,9,36,74,A9,C12,G2
09_37_57,xcond_1,GRCm39,387,550,892,386,549,891,1,1,1,9,37,57,A9,D1,E9
09_37_63,xcond_1,GRCm39,456,656,1099,456,656,1099,0,0,0,9,37,63,A9,D1,F3
09_37_69,xcond_1,GRCm39,2072,3890,6393,2070,3888,6391,2,2,2,9,37,69,A9,D1,F9
09_38_17,xcond_1,GRCm39,436,571,909,436,571,909,0,0,0,9,38,17,A9,D2,B5
09_38_27,xcond_1,GRCm39,1520,2392,3841,1518,2390,3839,2,2,2,9,38,27,A9,D2,C3
09_38_31,xcond_1,GRCm39,707,972,1605,707,972,1605,0,0,0,9,38,31,A9,D2,C7
09_38_75,xcond_1,GRCm39,694,1009,1592,693,1008,1591,1,1,1,9,38,75,A9,D2,G3
09_38_76,xcond_1,GRCm39,1524,2847,4554,1524,2847,4554,0,0,0,9,38,76,A9,D2,G4
09_39_14,xcond_1,GRCm39,674,982,1589,674,982,1589,0,0,0,9,39,14,A9,D3,B2
09_39_23,xcond_1,GRCm39,658,1057,1597,657,1056,1595,1,1,2,9,39,23,A9,D3,B11
09_39_36,xcond_1,GRCm39,1341,2576,3994,1340,2575,3993,1,1,1,9,39,36,A9,D3,C12
09_39_39,xcond_1,GRCm39,690,1061,1584,690,1061,1584,0,0,0,9,39,39,A9,D3,D3
09_39_48,xcond_1,GRCm39,526,747,1140,526,747,1140,0,0,0,9,39,48,A9,D3,D12
09_39_55,xcond_1,GRCm39,550,746,1140,550,746,1140,0,0,0,9,39,55,A9,D3,E7
09_39_57,xcond_1,GRCm39,460,637,1007,458,634,998,2,3,9,9,39,57,A9,D3,E9
09_39_86,xcond_1,GRCm39,597,863,1328,595,861,1323,2,2,5,9,39,86,A9,D3,H2
09_39_87,xcond_1,GRCm39,1202,2427,3711,1201,2426,3710,1,1,1,9,39,87,A9,D3,H3
09_39_93,xcond_1,GRCm39,681,968,1475,680,967,1474,1,1,1,9,39,93,A9,D3,H9
09_40_12,xcond_1,GRCm39,587,874,1430,587,874,1430,0,0,0,9,40,12,A9,D4,A12
09_40_71,xcond_1,GRCm39,438,609,985,436,607,982,2,2,3,9,40,71,A9,D4,F11
09_41_38,xcond_1,GRCm39,453,589,953,452,588,952,1,1,1,9,41,38,A9,D5,D2
09_41_64,xcond_1,GRCm39,607,886,1473,607,886,1473,0,0,0,9,41,64,A9,D5,F4
09_41_76,xcond_1,GRCm39,811,1129,1859,810,1128,1854,1,1,5,9,41,76,A9,D5,G4
09_42_17,xcond_1,GRCm39,538,809,1269,538,809,1269,0,0,0,9,42,17,A9,D6,B5
09_42_68,xcond_1,GRCm39,588,748,1228,586,746,1226,2,2,2,9,42,68,A9,D6,F8
09_42_71,xcond_1,GRCm39,337,422,681,337,422,681,0,0,0,9,42,71,A9,D6,F11
09_42_74,xcond_1,GRCm39,1227,2188,3413,1227,2188,3413,0,0,0,9,42,74,A9,D6,G2
09_43_74,xcond_1,GRCm39,499,838,1323,499,838,1323,0,0,0,9,43,74,A9,D7,G2
09_44_29,xcond_1,GRCm39,473,598,1007,473,598,1007,0,0,0,9,44,29,A9,D8,C5
09_44_40,xcond_1,GRCm39,517,749,1204,516,748,1203,1,1,1,9,44,40,A9,D8,D4
09_44_49,xcond_1,GRCm39,516,730,1172,516,730,1172,0,0,0,9,44,49,A9,D8,E1
09_44_66,xcond_1,GRCm39,1545,2571,4258,1544,2570,4257,1,1,1,9,44,66,A9,D8,F6
09_44_73,xcond_1,GRCm39,695,1240,1920,695,1240,1920,0,0,0,9,44,73,A9,D8,G1
09_44_93,xcond_1,GRCm39,279,393,626,279,393,626,0,0,0,9,44,93,A9,D8,H9
09_45_07,xcond_1,GRCm39,499,620,973,499,620,973,0,0,0,9,45,7,A9,D9,A7
09_45_12,xcond_1,GRCm39,1111,1739,2845,1110,1738,2843,1,1,2,9,45,12,A9,D9,A12
09_45_39,xcond_1,GRCm39,426,563,904,425,562,899,1,1,5,9,45,39,A9,D9,D3
09_45_88,xcond_1,GRCm39,473,683,1099,473,683,1099,0,0,0,9,45,88,A9,D9,H4
09_45_96,xcond_1,GRCm39,527,716,1178,525,714,1176,2,2,2,9,45,96,A9,D9,H12
09_46_23,xcond_1,GRCm39,310,390,669,309,389,667,1,1,2,9,46,23,A9,D10,B11
09_46_62,xcond_1,GRCm39,662,942,1528,660,940,1526,2,2,2,9,46,62,A9,D10,F2
09_47_24,xcond_1,GRCm39,474,753,1173,474,753,1173,0,0,0,9,47,24,A9,D11,B12
09_47_75,xcond_1,GRCm39,261,565,909,261,565,909,0,0,0,9,47,75,A9,D11,G3
09_47_81,xcond_1,GRCm39,282,344,556,282,344,556,0,0,0,9,47,81,A9,D11,G9
09_48_09,xcond_1,GRCm39,379,478,772,379,478,772,0,0,0,9,48,9,A9,D12,A9
09_48_71,xcond_1,GRCm39,705,1194,1896,704,1193,1895,1,1,1,9,48,71,A9,D12,F11
09_48_73,xcond_1,GRCm39,667,1167,1893,666,1166,1891,1,1,2,9,48,73,A9,D12,G1
09_48_92,xcond_1,GRCm39,248,387,579,247,386,578,1,1,1,9,48,92,A9,D12,H8
09_48_95,xcond_1,GRCm39,950,1721,2713,949,1720,2712,1,1,1,9,48,95,A9,D12,H11
09_49_48,xcond_1,GRCm39,262,334,546,262,334,546,0,0,0,9,49,48,A9,E1,D12
09_49_67,xcond_1,GRCm39,1368,2324,3748,1368,2324,3748,0,0,0,9,49,67,A9,E1,F7
09_49_71,xcond_1,GRCm39,419,533,880,418,532,878,1,1,2,9,49,71,A9,E1,F11
09_49_72,xcond_1,GRCm39,899,1278,2157,899,1278,2157,0,0,0,9,49,72,A9,E1,F12
09_49_76,xcond_1,GRCm39,526,738,1128,525,737,1126,1,1,2,9,49,76,A9,E1,G4
09_49_86,xcond_1,GRCm39,2061,3693,5994,2058,3688,5988,3,5,6,9,49,86,A9,E1,H2
09_50_30,xcond_1,GRCm39,876,1452,2378,875,1451,2377,1,1,1,9,50,30,A9,E2,C6
09_50_47,xcond_1,GRCm39,554,741,1223,554,741,1223,0,0,0,9,50,47,A9,E2,D11
09_50_49,xcond_1,GRCm39,851,1473,2429,850,1472,2428,1,1,1,9,50,49,A9,E2,E1
09_50_53,xcond_1,GRCm39,741,1215,1959,740,1214,1958,1,1,1,9,50,53,A9,E2,E5
09_51_05,xcond_1,GRCm39,602,947,1507,602,947,1507,0,0,0,9,51,5,A9,E3,A5
09_51_54,xcond_1,GRCm39,557,845,1391,555,843,1386,2,2,5,9,51,54,A9,E3,E6
09_51_61,xcond_1,GRCm39,601,829,1371,600,828,1369,1,1,2,9,51,61,A9,E3,F1
09_52_57,xcond_1,GRCm39,891,1466,2335,891,1466,2335,0,0,0,9,52,57,A9,E4,E9
09_52_62,xcond_1,GRCm39,587,734,1172,586,733,1170,1,1,2,9,52,62,A9,E4,F2
09_52_89,xcond_1,GRCm39,714,933,1491,714,933,1491,0,0,0,9,52,89,A9,E4,H5
09_53_27,xcond_1,GRCm39,456,664,1081,456,664,1081,0,0,0,9,53,27,A9,E5,C3
09_53_74,xcond_1,GRCm39,270,399,690,270,399,690,0,0,0,9,53,74,A9,E5,G2
09_53_81,xcond_1,GRCm39,407,546,882,407,546,882,0,0,0,9,53,81,A9,E5,G9
09_54_28,xcond_1,GRCm39,663,927,1517,662,926,1515,1,1,2,9,54,28,A9,E6,C4
09_54_40,xcond_1,GRCm39,661,963,1553,661,963,1553,0,0,0,9,54,40,A9,E6,D4
09_54_43,xcond_1,GRCm39,626,1044,1689,626,1044,1689,0,0,0,9,54,43,A9,E6,D7
09_54_50,xcond_1,GRCm39,791,1127,1908,789,1125,1904,2,2,4,9,54,50,A9,E6,E2
09_54_72,xcond_1,GRCm39,430,564,966,430,564,966,0,0,0,9,54,72,A9,E6,F12
09_55_26,xcond_1,GRCm39,259,315,576,259,315,576,0,0,0,9,55,26,A9,E7,C2
09_55_47,xcond_1,GRCm39,290,397,622,290,397,622,0,0,0,9,55,47,A9,E7,D11
09_55_87,xcond_1,GRCm39,536,829,1324,536,829,1324,0,0,0,9,55,87,A9,E7,H3
09_56_39,xcond_1,GRCm39,1045,1668,2670,1042,1665,2667,3,3,3,9,56,39,A9,E8,D3
09_56_52,xcond_1,GRCm39,555,730,1174,555,730,1174,0,0,0,9,56,52,A9,E8,E4
09_56_56,xcond_1,GRCm39,1017,1749,2861,1014,1745,2854,3,4,7,9,56,56,A9,E8,E8
09_56_72,xcond_1,GRCm39,626,849,1407,624,847,1404,2,2,3,9,56,72,A9,E8,F12
09_56_74,xcond_1,GRCm39,832,1417,2256,831,1416,2254,1,1,2,9,56,74,A9,E8,G2
09_56_83,xcond_1,GRCm39,1000,1626,2595,999,1625,2594,1,1,1,9,56,83,A9,E8,G11
09_57_96,xcond_1,GRCm39,1080,1761,2838,1079,1760,2837,1,1,1,9,57,96,A9,E9,H12
09_58_09,xcond_1,GRCm39,242,295,475,242,295,475,0,0,0,9,58,9,A9,E10,A9
09_58_20,xcond_1,GRCm39,638,963,1488,637,962,1486,1,1,2,9,58,20,A9,E10,B8
09_58_41,xcond_1,GRCm39,945,1633,2632,944,1632,2631,1,1,1,9,58,41,A9,E10,D5
09_58_59,xcond_1,GRCm39,666,1036,1678,666,1036,1678,0,0,0,9,58,59,A9,E10,E11
09_58_89,xcond_1,GRCm39,604,811,1381,604,811,1381,0,0,0,9,58,89,A9,E10,H5
09_59_09,xcond_1,GRCm39,288,364,554,288,364,554,0,0,0,9,59,9,A9,E11,A9
09_59_31,xcond_1,GRCm39,652,972,1572,652,972,1572,0,0,0,9,59,31,A9,E11,C7
09_59_53,xcond_1,GRCm39,228,445,684,228,445,684,0,0,0,9,59,53,A9,E11,E5
09_59_88,xcond_1,GRCm39,1184,2192,3587,1181,2189,3584,3,3,3,9,59,88,A9,E11,H4
09_60_26,xcond_1,GRCm39,327,446,710,327,446,710,0,0,0,9,60,26,A9,E12,C2
09_60_39,xcond_1,GRCm39,491,701,1101,491,701,1101,0,0,0,9,60,39,A9,E12,D3
09_60_76,xcond_1,GRCm39,516,700,1130,516,700,1130,0,0,0,9,60,76,A9,E12,G4
09_61_47,xcond_1,GRCm39,672,1256,2005,671,1255,2002,1,1,3,9,61,47,A9,F1,D11
09_62_08,xcond_1,GRCm39,571,757,1264,571,757,1264,0,0,0,9,62,8,A9,F2,A8
09_62_50,xcond_1,GRCm39,990,1500,2466,989,1499,2465,1,1,1,9,62,50,A9,F2,E2
09_62_53,xcond_1,GRCm39,364,436,718,364,436,718,0,0,0,9,62,53,A9,F2,E5
09_62_67,xcond_1,GRCm39,719,1118,1789,719,1118,1789,0,0,0,9,62,67,A9,F2,F7
09_62_69,xcond_1,GRCm39,200,238,385,200,238,385,0,0,0,9,62,69,A9,F2,F9
09_63_12,xcond_1,GRCm39,529,778,1260,528,777,1259,1,1,1,9,63,12,A9,F3,A12
09_63_18,xcond_1,GRCm39,655,869,1433,655,869,1433,0,0,0,9,63,18,A9,F3,B6
09_63_36,xcond_1,GRCm39,1084,1641,2654,1082,1639,2652,2,2,2,9,63,36,A9,F3,C12
09_64_06,xcond_1,GRCm39,475,669,1109,473,665,1105,2,4,4,9,64,6,A9,F4,A6
09_64_50,xcond_1,GRCm39,1887,3350,5527,1883,3344,5519,4,6,8,9,64,50,A9,F4,E2
09_64_52,xcond_1,GRCm39,615,941,1582,615,941,1582,0,0,0,9,64,52,A9,F4,E4
09_65_13,xcond_1,GRCm39,445,639,1035,444,638,1034,1,1,1,9,65,13,A9,F5,B1
09_65_48,xcond_1,GRCm39,725,1107,1724,725,1107,1724,0,0,0,9,65,48,A9,F5,D12
09_65_62,xcond_1,GRCm39,2322,4415,7358,2320,4407,7345,2,8,13,9,65,62,A9,F5,F2
09_65_66,xcond_1,GRCm39,286,658,1048,286,658,1048,0,0,0,9,65,66,A9,F5,F6
09_65_72,xcond_1,GRCm39,969,1499,2504,966,1494,2493,3,5,11,9,65,72,A9,F5,F12
09_66_28,xcond_1,GRCm39,567,836,1376,566,835,1375,1,1,1,9,66,28,A9,F6,C4
09_66_43,xcond_1,GRCm39,637,968,1591,637,968,1591,0,0,0,9,66,43,A9,F6,D7
09_66_53,xcond_1,GRCm39,418,573,958,418,573,958,0,0,0,9,66,53,A9,F6,E5
09_66_87,xcond_1,GRCm39,1566,2990,4950,1566,2990,4950,0,0,0,9,66,87,A9,F6,H3
09_67_01,xcond_1,GRCm39,185,305,464,185,305,464,0,0,0,9,67,1,A9,F7,A1
09_67_15,xcond_1,GRCm39,972,1434,2351,971,1433,2349,1,1,2,9,67,15,A9,F7,B3
09_67_17,xcond_1,GRCm39,645,879,1462,645,879,1462,0,0,0,9,67,17,A9,F7,B5
09_67_26,xcond_1,GRCm39,1954,3452,5572,1952,3450,5569,2,2,3,9,67,26,A9,F7,C2
09_67_30,xcond_1,GRCm39,829,1474,2405,827,1471,2394,2,3,11,9,67,30,A9,F7,C6
09_67_31,xcond_1,GRCm39,1134,1850,2963,1134,1850,2963,0,0,0,9,67,31,A9,F7,C7
09_67_48,xcond_1,GRCm39,489,717,1123,488,716,1122,1,1,1,9,67,48,A9,F7,D12
09_67_50,xcond_1,GRCm39,855,1249,2080,854,1248,2078,1,1,2,9,67,50,A9,F7,E2
09_67_73,xcond_1,GRCm39,1480,2728,4398,1478,2726,4395,2,2,3,9,67,73,A9,F7,G1
09_67_84,xcond_1,GRCm39,1883,4391,7136,1881,4388,7133,2,3,3,9,67,84,A9,F7,G12
09_68_07,xcond_1,GRCm39,894,1467,2334,893,1466,2333,1,1,1,9,68,7,A9,F8,A7
09_68_57,xcond_1,GRCm39,338,465,735,338,465,735,0,0,0,9,68,57,A9,F8,E9
09_68_63,xcond_1,GRCm39,582,879,1427,581,878,1425,1,1,2,9,68,63,A9,F8,F3
09_68_92,xcond_1,GRCm39,1078,1988,3253,1076,1986,3250,2,2,3,9,68,92,A9,F8,H8
09_69_02,xcond_1,GRCm39,324,414,631,323,413,629,1,1,2,9,69,2,A9,F9,A2
09_69_03,xcond_1,GRCm39,666,941,1530,665,940,1528,1,1,2,9,69,3,A9,F9,A3
09_69_71,xcond_1,GRCm39,154,240,360,154,240,360,0,0,0,9,69,71,A9,F9,F11
09_69_73,xcond_1,GRCm39,650,1219,1964,649,1218,1963,1,1,1,9,69,73,A9,F9,G1
09_69_87,xcond_1,GRCm39,539,737,1175,538,736,1172,1,1,3,9,69,87,A9,F9,H3
09_69_91,xcond_1,GRCm39,313,386,599,313,386,599,0,0,0,9,69,91,A9,F9,H7
09_70_32,xcond_1,GRCm39,829,1424,2304,827,1422,2302,2,2,2,9,70,32,A9,F10,C8
09_70_78,xcond_1,GRCm39,545,759,1258,544,757,1255,1,2,3,9,70,78,A9,F10,G6
09_71_81,xcond_1,GRCm39,636,996,1602,636,996,1602,0,0,0,9,71,81,A9,F11,G9
09_71_93,xcond_1,GRCm39,290,369,614,290,369,614,0,0,0,9,71,93,A9,F11,H9
09_72_08,xcond_1,GRCm39,521,786,1224,520,785,1223,1,1,1,9,72,8,A9,F12,A8
09_72_39,xcond_1,GRCm39,205,247,417,205,247,417,0,0,0,9,72,39,A9,F12,D3
09_72_83,xcond_1,GRCm39,3443,8530,13833,3440,8522,13820,3,8,13,9,72,83,A9,F12,G11
09_72_88,xcond_1,GRCm39,2395,4802,7676,2394,4801,7673,1,1,3,9,72,88,A9,F12,H4
09_73_07,xcond_1,GRCm39,1362,3033,4777,1360,3031,4774,2,2,3,9,73,7,A9,G1,A7
09_73_15,xcond_1,GRCm39,426,603,958,426,603,958,0,0,0,9,73,15,A9,G1,B3
09_73_59,xcond_1,GRCm39,1134,1674,2687,1132,1672,2684,2,2,3,9,73,59,A9,G1,E11
09_74_17,xcond_1,GRCm39,720,1266,2034,719,1265,2033,1,1,1,9,74,17,A9,G2,B5
09_74_40,xcond_1,GRCm39,871,1563,2460,869,1561,2458,2,2,2,9,74,40,A9,G2,D4
09_74_73,xcond_1,GRCm39,758,1248,1948,757,1247,1946,1,1,2,9,74,73,A9,G2,G1
09_75_39,xcond_1,GRCm39,600,1028,1591,599,1027,1590,1,1,1,9,75,39,A9,G3,D3
09_75_42,xcond_1,GRCm39,514,695,1148,512,692,1144,2,3,4,9,75,42,A9,G3,D6
09_76_21,xcond_1,GRCm39,242,293,467,242,293,467,0,0,0,9,76,21,A9,G4,B9
09_76_43,xcond_1,GRCm39,565,860,1396,565,860,1396,0,0,0,9,76,43,A9,G4,D7
09_76_55,xcond_1,GRCm39,613,893,1444,612,892,1442,1,1,2,9,76,55,A9,G4,E7
09_77_09,xcond_1,GRCm39,257,305,485,257,305,485,0,0,0,9,77,9,A9,G5,A9
09_77_44,xcond_1,GRCm39,2265,4485,7095,2262,4481,7089,3,4,6,9,77,44,A9,G5,D8
09_77_69,xcond_1,GRCm39,740,1104,1691,740,1104,1691,0,0,0,9,77,69,A9,G5,F9
09_77_96,xcond_1,GRCm39,676,904,1412,675,903,1411,1,1,1,9,77,96,A9,G5,H12
09_78_11,xcond_1,GRCm39,421,612,995,421,612,995,0,0,0,9,78,11,A9,G6,A11
09_78_21,xcond_1,GRCm39,1525,2956,4655,1520,2950,4649,5,6,6,9,78,21,A9,G6,B9
09_78_45,xcond_1,GRCm39,381,468,799,381,468,799,0,0,0,9,78,45,A9,G6,D9
09_78_65,xcond_1,GRCm39,1110,2502,4065,1109,2500,4061,1,2,4,9,78,65,A9,G6,F5
09_79_21,xcond_1,GRCm39,258,335,517,258,335,517,0,0,0,9,79,21,A9,G7,B9
09_79_36,xcond_1,GRCm39,808,1174,1841,807,1173,1840,1,1,1,9,79,36,A9,G7,C12
09_79_57,xcond_1,GRCm39,327,432,720,327,432,720,0,0,0,9,79,57,A9,G7,E9
09_79_73,xcond_1,GRCm39,902,1382,2314,901,1381,2312,1,1,2,9,79,73,A9,G7,G1
09_79_81,xcond_1,GRCm39,308,379,608,308,379,608,0,0,0,9,79,81,A9,G7,G9
09_79_84,xcond_1,GRCm39,738,1239,2042,738,1239,2042,0,0,0,9,79,84,A9,G7,G12
09_80_05,xcond_1,GRCm39,931,1578,2498,931,1578,2498,0,0,0,9,80,5,A9,G8,A5
09_80_19,xcond_1,GRCm39,1269,2072,3278,1267,2070,3275,2,2,3,9,80,19,A9,G8,B7
09_80_35,xcond_1,GRCm39,482,645,1081,481,644,1080,1,1,1,9,80,35,A9,G8,C11
09_80_40,xcond_1,GRCm39,651,916,1468,648,913,1464,3,3,4,9,80,40,A9,G8,D4
09_80_88,xcond_1,GRCm39,471,669,1048,471,669,1048,0,0,0,9,80,88,A9,G8,H4
09_81_61,xcond_1,GRCm39,587,900,1414,584,896,1410,3,4,4,9,81,61,A9,G9,F1
09_81_62,xcond_1,GRCm39,678,1044,1650,678,1044,1650,0,0,0,9,81,62,A9,G9,F2
09_82_08,xcond_1,GRCm39,588,778,1246,587,777,1245,1,1,1,9,82,8,A9,G10,A8
09_82_17,xcond_1,GRCm39,472,624,1000,472,624,1000,0,0,0,9,82,17,A9,G10,B5
09_82_80,xcond_1,GRCm39,840,1378,2187,839,1377,2186,1,1,1,9,82,80,A9,G10,G8
09_82_84,xcond_1,GRCm39,1670,3246,5216,1667,3243,5212,3,3,4,9,82,84,A9,G10,G12
09_83_04,xcond_1,GRCm39,363,578,919,363,578,919,0,0,0,9,83,4,A9,G11,A4
09_83_24,xcond_1,GRCm39,312,402,634,311,401,628,1,1,6,9,83,24,A9,G11,B12
09_83_41,xcond_1,GRCm39,389,535,875,389,535,875,0,0,0,9,83,41,A9,G11,D5
09_83_52,xcond_1,GRCm39,819,1408,2277,818,1406,2275,1,2,2,9,83,52,A9,G11,E4
09_84_14,xcond_1,GRCm39,951,1749,2873,951,1749,2873,0,0,0,9,84,14,A9,G12,B2
09_84_55,xcond_1,GRCm39,366,565,915,366,565,915,0,0,0,9,84,55,A9,G12,E7
09_84_69,xcond_1,GRCm39,333,404,615,333,404,615,0,0,0,9,84,69,A9,G12,F9
09_85_13,xcond_1,GRCm39,602,923,1413,602,923,1413,0,0,0,9,85,13,A9,H1,B1
09_85_21,xcond_1,GRCm39,461,784,1239,460,782,1231,1,2,8,9,85,21,A9,H1,B9
09_85_47,xcond_1,GRCm39,1015,1787,2793,1014,1786,2792,1,1,1,9,85,47,A9,H1,D11
09_85_52,xcond_1,GRCm39,524,783,1277,523,782,1276,1,1,1,9,85,52,A9,H1,E4
09_86_17,xcond_1,GRCm39,370,503,800,369,502,799,1,1,1,9,86,17,A9,H2,B5
09_86_32,xcond_1,GRCm39,456,630,1036,455,629,1035,1,1,1,9,86,32,A9,H2,C8
09_86_44,xcond_1,GRCm39,474,647,1069,474,647,1069,0,0,0,9,86,44,A9,H2,D8
09_86_59,xcond_1,GRCm39,488,711,1147,488,711,1147,0,0,0,9,86,59,A9,H2,E11
09_86_72,xcond_1,GRCm39,766,1022,1684,766,1022,1684,0,0,0,9,86,72,A9,H2,F12
09_86_80,xcond_1,GRCm39,333,441,724,332,440,723,1,1,1,9,86,80,A9,H2,G8
09_87_01,xcond_1,GRCm39,617,921,1447,617,921,1447,0,0,0,9,87,1,A9,H3,A1
09_87_15,xcond_1,GRCm39,800,1302,2036,798,1299,2032,2,3,4,9,87,15,A9,H3,B3
09_87_16,xcond_1,GRCm39,597,827,1338,597,827,1338,0,0,0,9,87,16,A9,H3,B4
09_87_32,xcond_1,GRCm39,325,427,621,325,427,621,0,0,0,9,87,32,A9,H3,C8
09_87_63,xcond_1,GRCm39,723,969,1567,721,967,1565,2,2,2,9,87,63,A9,H3,F3
09_87_68,xcond_1,GRCm39,441,577,911,440,576,910,1,1,1,9,87,68,A9,H3,F8
09_88_27,xcond_1,GRCm39,459,621,922,459,621,922,0,0,0,9,88,27,A9,H4,C3
09_88_29,xcond_1,GRCm39,943,1496,2413,939,1492,2403,4,4,10,9,88,29,A9,H4,C5
09_88_37,xcond_1,GRCm39,482,707,1076,480,705,1074,2,2,2,9,88,37,A9,H4,D1
09_88_57,xcond_1,GRCm39,394,479,728,394,479,728,0,0,0,9,88,57,A9,H4,E9
09_88_86,xcond_1,GRCm39,2185,4016,6418,2179,4009,6408,6,7,10,9,88,86,A9,H4,H2
09_89_33,xcond_1,GRCm39,255,375,589,254,374,588,1,1,1,9,89,33,A9,H5,C9
09_89_45,xcond_1,GRCm39,491,692,1104,491,692,1104,0,0,0,9,89,45,A9,H5,D9
09_89_96,xcond_1,GRCm39,823,1185,1966,823,1185,1966,0,0,0,9,89,96,A9,H5,H12
09_90_03,xcond_1,GRCm39,1869,3286,5468,1869,3286,5468,0,0,0,9,90,3,A9,H6,A3
09_90_26,xcond_1,GRCm39,715,1027,1713,714,1026,1708,1,1,5,9,90,26,A9,H6,C2
09_90_27,xcond_1,GRCm39,449,566,943,448,565,942,1,1,1,9,90,27,A9,H6,C3
09_90_84,xcond_1,GRCm39,611,942,1535,608,939,1532,3,3,3,9,90,84,A9,H6,G12
09_91_21,xcond_1,GRCm39,530,806,1256,529,805,1255,1,1,1,9,91,21,A9,H7,B9
09_91_25,xcond_1,GRCm39,513,727,1164,513,727,1164,0,0,0,9,91,25,A9,H7,C1
09_91_65,xcond_1,GRCm39,476,706,1151,475,705,1150,1,1,1,9,91,65,A9,H7,F5
09_92_38,xcond_1,GRCm39,766,1045,1734,765,1044,1733,1,1,1,9,92,38,A9,H8,D2
09_92_49,xcond_1,GRCm39,322,491,808,321,488,804,1,3,4,9,92,49,A9,H8,E1
09_92_54,xcond_1,GRCm39,559,791,1310,558,790,1309,1,1,1,9,92,54,A9,H8,E6
09_92_85,xcond_1,GRCm39,2445,5308,8602,2443,5304,8597,2,4,5,9,92,85,A9,H8,H1
09_92_88,xcond_1,GRCm39,782,1217,1995,781,1216,1992,1,1,3,9,92,88,A9,H8,H4
09_93_09,xcond_1,GRCm39,157,214,330,156,213,328,1,1,2,9,93,9,A9,H9,A9
09_93_16,xcond_1,GRCm39,634,985,1597,634,985,1597,0,0,0,9,93,16,A9,H9,B4
09_93_39,xcond_1,GRCm39,366,490,757,366,490,757,0,0,0,9,93,39,A9,H9,D3
09_93_83,xcond_1,GRCm39,716,1041,1664,715,1040,1663,1,1,1,9,93,83,A9,H9,G11
09_94_13,xcond_1,GRCm39,834,1527,2425,834,1527,2425,0,0,0,9,94,13,A9,H10,B1
09_94_53,xcond_1,GRCm39,541,854,1420,538,851,1416,3,3,4,9,94,53,A9,H10,E5
09_94_61,xcond_1,GRCm39,476,624,1038,476,624,1038,0,0,0,9,94,61,A9,H10,F1
09_94_77,xcond_1,GRCm39,445,574,910,445,574,910,0,0,0,9,94,77,A9,H10,G5
09_94_96,xcond_1,GRCm39,329,587,897,329,587,897,0,0,0,9,94,96,A9,H10,H12
09_95_03,xcond_1,GRCm39,584,851,1373,584,851,1373,0,0,0,9,95,3,A9,H11,A3
09_95_04,xcond_1,GRCm39,1296,2034,3244,1294,2032,3240,2,2,4,9,95,4,A9,H11,A4
09_95_12,xcond_1,GRCm39,412,521,857,412,521,857,0,0,0,9,95,12,A9,H11,A12
09_95_17,xcond_1,GRCm39,586,878,1408,585,877,1407,1,1,1,9,95,17,A9,H11,B5
09_95_95,xcond_1,GRCm39,604,957,1591,604,957,1591,0,0,0,9,95,95,A9,H11,H11
10_01_19,xcond_1,GRCm39,787,1138,1861,787,1138,1861,0,0,0,10,1,19,A10,A1,B7
10_01_54,xcond_1,GRCm39,661,1017,1655,660,1016,1654,1,1,1,10,1,54,A10,A1,E6
10_01_67,xcond_1,GRCm39,379,481,819,379,481,819,0,0,0,10,1,67,A10,A1,F7
10_02_44,xcond_1,GRCm39,528,669,1129,526,667,1126,2,2,3,10,2,44,A10,A2,D8
10_02_90,xcond_1,GRCm39,1737,2923,4772,1736,2922,4771,1,1,1,10,2,90,A10,A2,H6
10_03_69,xcond_1,GRCm39,493,680,1088,493,680,1088,0,0,0,10,3,69,A10,A3,F9
10_03_76,xcond_1,GRCm39,438,730,1147,436,728,1143,2,2,4,10,3,76,A10,A3,G4
10_04_45,xcond_1,GRCm39,297,449,788,297,449,788,0,0,0,10,4,45,A10,A4,D9
10_05_20,xcond_1,GRCm39,570,813,1291,568,811,1289,2,2,2,10,5,20,A10,A5,B8
10_05_48,xcond_1,GRCm39,456,615,983,455,614,982,1,1,1,10,5,48,A10,A5,D12
10_05_60,xcond_1,GRCm39,599,839,1372,596,836,1366,3,3,6,10,5,60,A10,A5,E12
10_05_76,xcond_1,GRCm39,1264,2271,3686,1263,2270,3685,1,1,1,10,5,76,A10,A5,G4
10_06_19,xcond_1,GRCm39,654,912,1520,654,912,1520,0,0,0,10,6,19,A10,A6,B7
10_06_23,xcond_1,GRCm39,553,856,1381,551,854,1378,2,2,3,10,6,23,A10,A6,B11
10_06_24,xcond_1,GRCm39,428,600,940,426,597,936,2,3,4,10,6,24,A10,A6,B12
10_06_33,xcond_1,GRCm39,121,332,538,121,332,538,0,0,0,10,6,33,A10,A6,C9
10_06_78,xcond_1,GRCm39,139,399,677,137,397,675,2,2,2,10,6,78,A10,A6,G6
10_06_86,xcond_1,GRCm39,943,1399,2310,941,1396,2307,2,3,3,10,6,86,A10,A6,H2
10_07_03,xcond_1,GRCm39,1550,3975,6525,1548,3973,6520,2,2,5,10,7,3,A10,A7,A3
10_07_49,xcond_1,GRCm39,366,477,799,365,476,797,1,1,2,10,7,49,A10,A7,E1
10_08_07,xcond_1,GRCm39,202,257,398,202,257,398,0,0,0,10,8,7,A10,A8,A7
10_08_08,xcond_1,GRCm39,957,1387,2293,955,1385,2290,2,2,3,10,8,8,A10,A8,A8
10_08_14,xcond_1,GRCm39,726,1027,1688,726,1027,1688,0,0,0,10,8,14,A10,A8,B2
10_08_17,xcond_1,GRCm39,517,751,1227,517,751,1227,0,0,0,10,8,17,A10,A8,B5
10_08_41,xcond_1,GRCm39,247,295,466,247,295,466,0,0,0,10,8,41,A10,A8,D5
10_08_49,xcond_1,GRCm39,726,1050,1657,726,1050,1657,0,0,0,10,8,49,A10,A8,E1
10_09_14,xcond_1,GRCm39,517,814,1330,517,814,1330,0,0,0,10,9,14,A10,A9,B2
10_09_26,xcond_1,GRCm39,252,379,583,251,378,582,1,1,1,10,9,26,A10,A9,C2
10_09_27,xcond_1,GRCm39,1758,3735,5990,1756,3733,5988,2,2,2,10,9,27,A10,A9,C3
10_10_48,xcond_1,GRCm39,390,536,828,389,535,827,1,1,1,10,10,48,A10,A10,D12
10_10_52,xcond_1,GRCm39,189,221,400,189,221,400,0,0,0,10,10,52,A10,A10,E4
10_10_86,xcond_1,GRCm39,291,382,579,291,382,579,0,0,0,10,10,86,A10,A10,H2
10_10_92,xcond_1,GRCm39,336,534,836,336,534,836,0,0,0,10,10,92,A10,A10,H8
10_10_96,xcond_1,GRCm39,378,613,979,376,611,977,2,2,2,10,10,96,A10,A10,H12
10_11_38,xcond_1,GRCm39,1066,1859,2981,1066,1859,2981,0,0,0,10,11,38,A10,A11,D2
10_11_47,xcond_1,GRCm39,984,1448,2266,983,1447,2265,1,1,1,10,11,47,A10,A11,D11
10_12_30,xcond_1,GRCm39,429,544,889,427,542,887,2,2,2,10,12,30,A10,A12,C6
10_12_48,xcond_1,GRCm39,356,569,916,356,569,916,0,0,0,10,12,48,A10,A12,D12
10_12_64,xcond_1,GRCm39,1506,2891,4648,1505,2890,4647,1,1,1,10,12,64,A10,A12,F4
10_12_72,xcond_1,GRCm39,296,358,569,295,357,568,1,1,1,10,12,72,A10,A12,F12
10_12_96,xcond_1,GRCm39,718,1409,2274,716,1406,2271,2,3,3,10,12,96,A10,A12,H12
10_13_16,xcond_1,GRCm39,526,697,1221,525,696,1219,1,1,2,10,13,16,A10,B1,B4
10_13_33,xcond_1,GRCm39,226,261,418,226,261,418,0,0,0,10,13,33,A10,B1,C9
10_13_57,xcond_1,GRCm39,504,725,1162,503,724,1160,1,1,2,10,13,57,A10,B1,E9
10_13_64,xcond_1,GRCm39,532,764,1243,531,763,1242,1,1,1,10,13,64,A10,B1,F4
10_13_93,xcond_1,GRCm39,261,311,495,261,311,495,0,0,0,10,13,93,A10,B1,H9
10_14_13,xcond_1,GRCm39,331,473,768,331,473,768,0,0,0,10,14,13,A10,B2,B1
10_14_28,xcond_1,GRCm39,368,482,823,367,481,822,1,1,1,10,14,28,A10,B2,C4
10_14_37,xcond_1,GRCm39,499,727,1167,499,727,1167,0,0,0,10,14,37,A10,B2,D1
10_14_39,xcond_1,GRCm39,565,730,1185,565,730,1185,0,0,0,10,14,39,A10,B2,D3
10_14_42,xcond_1,GRCm39,469,552,866,469,552,866,0,0,0,10,14,42,A10,B2,D6
10_14_45,xcond_1,GRCm39,848,1381,2274,847,1380,2272,1,1,2,10,14,45,A10,B2,D9
10_14_81,xcond_1,GRCm39,380,658,1073,378,656,1071,2,2,2,10,14,81,A10,B2,G9
10_15_06,xcond_1,GRCm39,470,689,1146,469,688,1145,1,1,1,10,15,6,A10,B3,A6
10_15_21,xcond_1,GRCm39,261,343,544,261,343,544,0,0,0,10,15,21,A10,B3,B9
10_15_60,xcond_1,GRCm39,1461,2461,3997,1459,2457,3992,2,4,5,10,15,60,A10,B3,E12
10_15_69,xcond_1,GRCm39,208,248,387,208,248,387,0,0,0,10,15,69,A10,B3,F9
10_15_85,xcond_1,GRCm39,469,636,1059,469,636,1059,0,0,0,10,15,85,A10,B3,H1
10_16_64,xcond_1,GRCm39,6957,32220,52860,6944,32185,52813,13,35,47,10,16,64,A10,B4,F4
10_16_96,xcond_1,GRCm39,447,610,997,447,610,997,0,0,0,10,16,96,A10,B4,H12
10_17_31,xcond_1,GRCm39,1374,2158,3483,1372,2155,3480,2,3,3,10,17,31,A10,B5,C7
10_17_40,xcond_1,GRCm39,535,734,1210,535,734,1210,0,0,0,10,17,40,A10,B5,D4
10_17_45,xcond_1,GRCm39,521,784,1268,519,782,1265,2,2,3,10,17,45,A10,B5,D9
10_17_91,xcond_1,GRCm39,628,917,1538,628,917,1538,0,0,0,10,17,91,A10,B5,H7
10_18_09,xcond_1,GRCm39,770,1229,1974,768,1221,1962,2,8,12,10,18,9,A10,B6,A9
10_18_26,xcond_1,GRCm39,523,969,1560,520,966,1557,3,3,3,10,18,26,A10,B6,C2
10_18_30,xcond_1,GRCm39,459,608,964,458,607,963,1,1,1,10,18,30,A10,B6,C6
10_18_60,xcond_1,GRCm39,304,398,655,303,397,654,1,1,1,10,18,60,A10,B6,E12
10_19_05,xcond_1,GRCm39,538,812,1307,537,810,1305,1,2,2,10,19,5,A10,B7,A5
10_19_67,xcond_1,GRCm39,667,1034,1639,666,1033,1638,1,1,1,10,19,67,A10,B7,F7
10_19_77,xcond_1,GRCm39,409,580,931,408,579,930,1,1,1,10,19,77,A10,B7,G5
10_19_96,xcond_1,GRCm39,633,841,1365,633,841,1365,0,0,0,10,19,96,A10,B7,H12
10_20_48,xcond_1,GRCm39,365,493,783,364,492,782,1,1,1,10,20,48,A10,B8,D12
10_20_63,xcond_1,GRCm39,505,669,1068,504,668,1060,1,1,8,10,20,63,A10,B8,F3
10_21_37,xcond_1,GRCm39,487,638,1025,487,638,1025,0,0,0,10,21,37,A10,B9,D1
10_21_68,xcond_1,GRCm39,384,531,882,384,531,882,0,0,0,10,21,68,A10,B9,F8
10_21_73,xcond_1,GRCm39,981,1772,2858,978,1767,2851,3,5,7,10,21,73,A10,B9,G1
10_21_96,xcond_1,GRCm39,542,792,1289,541,791,1288,1,1,1,10,21,96,A10,B9,H12
10_22_17,xcond_1,GRCm39,587,850,1409,586,849,1408,1,1,1,10,22,17,A10,B10,B5
10_22_25,xcond_1,GRCm39,376,578,933,376,578,933,0,0,0,10,22,25,A10,B10,C1
10_22_38,xcond_1,GRCm39,852,1272,2134,850,1270,2130,2,2,4,10,22,38,A10,B10,D2
10_22_80,xcond_1,GRCm39,551,1037,1663,551,1037,1663,0,0,0,10,22,80,A10,B10,G8
10_23_14,xcond_1,GRCm39,398,522,849,397,521,848,1,1,1,10,23,14,A10,B11,B2
10_23_57,xcond_1,GRCm39,182,229,368,182,229,368,0,0,0,10,23,57,A10,B11,E9
10_23_74,xcond_1,GRCm39,309,436,662,309,436,662,0,0,0,10,23,74,A10,B11,G2
10_24_14,xcond_1,GRCm39,606,1007,1604,605,1006,1603,1,1,1,10,24,14,A10,B12,B2
10_24_33,xcond_1,GRCm39,279,341,583,279,341,583,0,0,0,10,24,33,A10,B12,C9
10_24_40,xcond_1,GRCm39,833,1287,2108,832,1286,2107,1,1,1,10,24,40,A10,B12,D4
10_24_45,xcond_1,GRCm39,268,378,626,267,377,624,1,1,2,10,24,45,A10,B12,D9
10_24_95,xcond_1,GRCm39,475,710,1144,474,709,1143,1,1,1,10,24,95,A10,B12,H11
10_25_04,xcond_1,GRCm39,735,1270,2079,735,1270,2079,0,0,0,10,25,4,A10,C1,A4
10_25_84,xcond_1,GRCm39,233,270,442,233,270,442,0,0,0,10,25,84,A10,C1,G12
10_26_02,xcond_1,GRCm39,431,647,1011,430,646,1010,1,1,1,10,26,2,A10,C2,A2
10_26_15,xcond_1,GRCm39,578,847,1341,578,847,1341,0,0,0,10,26,15,A10,C2,B3
10_26_27,xcond_1,GRCm39,856,1425,2276,852,1421,2271,4,4,5,10,26,27,A10,C2,C3
10_26_31,xcond_1,GRCm39,1077,1614,2655,1077,1614,2655,0,0,0,10,26,31,A10,C2,C7
10_26_64,xcond_1,GRCm39,374,483,788,374,483,788,0,0,0,10,26,64,A10,C2,F4
10_26_73,xcond_1,GRCm39,496,738,1207,496,738,1207,0,0,0,10,26,73,A10,C2,G1
10_27_41,xcond_1,GRCm39,456,606,978,455,605,977,1,1,1,10,27,41,A10,C3,D5
10_27_48,xcond_1,GRCm39,647,994,1624,646,991,1621,1,3,3,10,27,48,A10,C3,D12
10_27_50,xcond_1,GRCm39,714,1091,1822,713,1090,1821,1,1,1,10,27,50,A10,C3,E2
10_28_09,xcond_1,GRCm39,1731,3154,5244,1729,3152,5242,2,2,2,10,28,9,A10,C4,A9
10_28_39,xcond_1,GRCm39,319,413,662,319,413,662,0,0,0,10,28,39,A10,C4,D3
10_29_12,xcond_1,GRCm39,475,640,1074,475,640,1074,0,0,0,10,29,12,A10,C5,A12
10_29_45,xcond_1,GRCm39,403,553,905,403,553,905,0,0,0,10,29,45,A10,C5,D9
10_29_96,xcond_1,GRCm39,203,352,572,203,352,572,0,0,0,10,29,96,A10,C5,H12
10_30_41,xcond_1,GRCm39,857,1210,1975,855,1207,1972,2,3,3,10,30,41,A10,C6,D5
10_30_43,xcond_1,GRCm39,204,230,385,204,230,385,0,0,0,10,30,43,A10,C6,D7
10_31_05,xcond_1,GRCm39,1208,1958,3169,1207,1957,3168,1,1,1,10,31,5,A10,C7,A5
10_31_06,xcond_1,GRCm39,396,651,1059,396,651,1059,0,0,0,10,31,6,A10,C7,A6
10_31_32,xcond_1,GRCm39,508,709,1169,506,706,1166,2,3,3,10,31,32,A10,C7,C8
10_31_45,xcond_1,GRCm39,530,688,1107,530,688,1107,0,0,0,10,31,45,A10,C7,D9
10_31_57,xcond_1,GRCm39,334,444,718,334,444,718,0,0,0,10,31,57,A10,C7,E9
10_31_65,xcond_1,GRCm39,491,675,1146,491,675,1146,0,0,0,10,31,65,A10,C7,F5
10_31_69,xcond_1,GRCm39,256,344,557,256,344,557,0,0,0,10,31,69,A10,C7,F9
10_32_45,xcond_1,GRCm39,278,351,582,278,351,582,0,0,0,10,32,45,A10,C8,D9
10_32_64,xcond_1,GRCm39,350,430,706,348,428,703,2,2,3,10,32,64,A10,C8,F4
10_32_73,xcond_1,GRCm39,490,716,1164,490,716,1164,0,0,0,10,32,73,A10,C8,G1
10_32_77,xcond_1,GRCm39,310,488,783,309,487,781,1,1,2,10,32,77,A10,C8,G5
10_32_93,xcond_1,GRCm39,532,940,1508,531,939,1507,1,1,1,10,32,93,A10,C8,H9
10_33_18,xcond_1,GRCm39,544,876,1429,544,876,1429,0,0,0,10,33,18,A10,C9,B6
10_33_21,xcond_1,GRCm39,523,700,1102,523,700,1102,0,0,0,10,33,21,A10,C9,B9
10_33_37,xcond_1,GRCm39,858,1506,2463,858,1506,2463,0,0,0,10,33,37,A10,C9,D1
10_33_48,xcond_1,GRCm39,476,604,960,476,604,960,0,0,0,10,33,48,A10,C9,D12
10_34_33,xcond_1,GRCm39,1109,1652,2661,1108,1649,2658,1,3,3,10,34,33,A10,C10,C9
10_34_36,xcond_1,GRCm39,541,685,1086,540,684,1085,1,1,1,10,34,36,A10,C10,C12
10_34_55,xcond_1,GRCm39,472,773,1256,472,773,1256,0,0,0,10,34,55,A10,C10,E7
10_34_59,xcond_1,GRCm39,250,343,515,250,343,515,0,0,0,10,34,59,A10,C10,E11
10_35_79,xcond_1,GRCm39,3655,9153,14583,3651,9143,14567,4,10,16,10,35,79,A10,C11,G7
10_35_85,xcond_1,GRCm39,1321,2322,3687,1320,2321,3686,1,1,1,10,35,85,A10,C11,H1
10_36_06,xcond_1,GRCm39,432,613,999,430,611,996,2,2,3,10,36,6,A10,C12,A6
10_36_30,xcond_1,GRCm39,1322,2328,3702,1320,2326,3700,2,2,2,10,36,30,A10,C12,C6
10_36_47,xcond_1,GRCm39,511,622,976,510,621,975,1,1,1,10,36,47,A10,C12,D11
10_36_52,xcond_1,GRCm39,181,220,305,181,220,305,0,0,0,10,36,52,A10,C12,E4
10_36_64,xcond_1,GRCm39,364,501,778,364,501,778,0,0,0,10,36,64,A10,C12,F4
10_36_77,xcond_1,GRCm39,1577,3165,5126,1575,3163,5124,2,2,2,10,36,77,A10,C12,G5
10_36_90,xcond_1,GRCm39,464,643,1039,464,643,1039,0,0,0,10,36,90,A10,C12,H6
10_37_03,xcond_1,GRCm39,1244,2278,3790,1243,2276,3787,1,2,3,10,37,3,A10,D1,A3
10_37_15,xcond_1,GRCm39,452,635,1018,449,632,1014,3,3,4,10,37,15,A10,D1,B3
10_37_18,xcond_1,GRCm39,210,384,652,209,383,650,1,1,2,10,37,18,A10,D1,B6
10_37_45,xcond_1,GRCm39,257,321,542,257,321,542,0,0,0,10,37,45,A10,D1,D9
10_37_74,xcond_1,GRCm39,1592,2591,4319,1590,2588,4316,2,3,3,10,37,74,A10,D1,G2
10_38_09,xcond_1,GRCm39,268,313,526,268,313,526,0,0,0,10,38,9,A10,D2,A9
10_38_30,xcond_1,GRCm39,471,631,1045,471,631,1045,0,0,0,10,38,30,A10,D2,C6
10_38_33,xcond_1,GRCm39,327,437,717,326,436,716,1,1,1,10,38,33,A10,D2,C9
10_38_35,xcond_1,GRCm39,1682,3286,5373,1678,3275,5357,4,11,16,10,38,35,A10,D2,C11
10_38_47,xcond_1,GRCm39,682,962,1606,681,961,1604,1,1,2,10,38,47,A10,D2,D11
10_38_62,xcond_1,GRCm39,1902,3509,5746,1899,3504,5740,3,5,6,10,38,62,A10,D2,F2
10_38_69,xcond_1,GRCm39,376,496,802,376,496,802,0,0,0,10,38,69,A10,D2,F9
10_39_09,xcond_1,GRCm39,424,591,917,423,590,916,1,1,1,10,39,9,A10,D3,A9
10_39_14,xcond_1,GRCm39,637,1091,1765,635,1088,1762,2,3,3,10,39,14,A10,D3,B2
10_39_15,xcond_1,GRCm39,403,591,960,403,591,960,0,0,0,10,39,15,A10,D3,B3
10_39_21,xcond_1,GRCm39,530,767,1200,530,767,1200,0,0,0,10,39,21,A10,D3,B9
10_39_26,xcond_1,GRCm39,1572,2668,4262,1569,2664,4258,3,4,4,10,39,26,A10,D3,C2
10_39_50,xcond_1,GRCm39,518,650,1106,518,650,1106,0,0,0,10,39,50,A10,D3,E2
10_39_60,xcond_1,GRCm39,532,707,1098,532,707,1098,0,0,0,10,39,60,A10,D3,E12
10_40_36,xcond_1,GRCm39,235,437,721,235,437,721,0,0,0,10,40,36,A10,D4,C12
10_40_59,xcond_1,GRCm39,530,774,1264,530,774,1264,0,0,0,10,40,59,A10,D4,E11
10_40_60,xcond_1,GRCm39,501,712,1219,501,712,1219,0,0,0,10,40,60,A10,D4,E12
10_40_96,xcond_1,GRCm39,303,379,631,303,379,631,0,0,0,10,40,96,A10,D4,H12
10_41_01,xcond_1,GRCm39,407,806,1300,405,804,1294,2,2,6,10,41,1,A10,D5,A1
10_41_28,xcond_1,GRCm39,1024,1624,2727,1024,1624,2727,0,0,0,10,41,28,A10,D5,C4
10_41_47,xcond_1,GRCm39,687,1039,1734,686,1038,1732,1,1,2,10,41,47,A10,D5,D11
10_41_78,xcond_1,GRCm39,1020,1801,3007,1018,1798,3002,2,3,5,10,41,78,A10,D5,G6
10_42_02,xcond_1,GRCm39,229,296,478,229,296,478,0,0,0,10,42,2,A10,D6,A2
10_42_21,xcond_1,GRCm39,432,676,1121,431,675,1120,1,1,1,10,42,21,A10,D6,B9
10_42_53,xcond_1,GRCm39,656,1053,1663,656,1053,1663,0,0,0,10,42,53,A10,D6,E5
10_43_45,xcond_1,GRCm39,263,362,549,263,362,549,0,0,0,10,43,45,A10,D7,D9
10_43_60,xcond_1,GRCm39,359,504,814,358,503,813,1,1,1,10,43,60,A10,D7,E12
10_44_31,xcond_1,GRCm39,640,1093,1721,640,1093,1721,0,0,0,10,44,31,A10,D8,C7
10_44_49,xcond_1,GRCm39,275,421,660,275,421,660,0,0,0,10,44,49,A10,D8,E1
10_44_65,xcond_1,GRCm39,252,305,493,252,305,493,0,0,0,10,44,65,A10,D8,F5
10_44_74,xcond_1,GRCm39,436,609,975,436,609,975,0,0,0,10,44,74,A10,D8,G2
10_44_88,xcond_1,GRCm39,714,1048,1724,714,1048,1724,0,0,0,10,44,88,A10,D8,H4
10_45_14,xcond_1,GRCm39,334,412,660,334,412,660,0,0,0,10,45,14,A10,D9,B2
10_45_20,xcond_1,GRCm39,662,907,1436,662,907,1436,0,0,0,10,45,20,A10,D9,B8
10_45_25,xcond_1,GRCm39,344,435,697,344,435,697,0,0,0,10,45,25,A10,D9,C1
10_45_33,xcond_1,GRCm39,223,287,441,223,287,441,0,0,0,10,45,33,A10,D9,C9
10_45_35,xcond_1,GRCm39,492,633,1018,490,631,1015,2,2,3,10,45,35,A10,D9,C11
10_45_41,xcond_1,GRCm39,453,661,1045,452,660,1043,1,1,2,10,45,41,A10,D9,D5
10_45_53,xcond_1,GRCm39,883,1263,2118,881,1259,2113,2,4,5,10,45,53,A10,D9,E5
10_45_56,xcond_1,GRCm39,645,1063,1718,645,1063,1718,0,0,0,10,45,56,A10,D9,E8
10_45_71,xcond_1,GRCm39,369,505,798,368,504,797,1,1,1,10,45,71,A10,D9,F11
10_45_75,xcond_1,GRCm39,418,549,909,418,549,909,0,0,0,10,45,75,A10,D9,G3
10_45_93,xcond_1,GRCm39,179,239,395,179,239,395,0,0,0,10,45,93,A10,D9,H9
10_46_13,xcond_1,GRCm39,571,768,1219,570,767,1218,1,1,1,10,46,13,A10,D10,B1
10_46_21,xcond_1,GRCm39,1083,1864,3043,1082,1863,3042,1,1,1,10,46,21,A10,D10,B9
10_46_45,xcond_1,GRCm39,574,865,1425,572,863,1422,2,2,3,10,46,45,A10,D10,D9
10_47_53,xcond_1,GRCm39,622,854,1425,621,852,1420,1,2,5,10,47,53,A10,D11,E5
10_47_81,xcond_1,GRCm39,209,238,366,207,236,364,2,2,2,10,47,81,A10,D11,G9
10_47_92,xcond_1,GRCm39,1260,1982,3197,1260,1982,3197,0,0,0,10,47,92,A10,D11,H8
10_48_42,xcond_1,GRCm39,847,1604,2526,847,1604,2526,0,0,0,10,48,42,A10,D12,D6
10_48_69,xcond_1,GRCm39,221,266,443,221,266,443,0,0,0,10,48,69,A10,D12,F9
10_49_20,xcond_1,GRCm39,324,505,797,324,505,797,0,0,0,10,49,20,A10,E1,B8
10_49_26,xcond_1,GRCm39,181,231,378,181,231,378,0,0,0,10,49,26,A10,E1,C2
10_49_73,xcond_1,GRCm39,599,1181,1880,597,1179,1878,2,2,2,10,49,73,A10,E1,G1
10_49_75,xcond_1,GRCm39,424,651,1088,423,650,1086,1,1,2,10,49,75,A10,E1,G3
10_49_83,xcond_1,GRCm39,402,530,859,402,530,859,0,0,0,10,49,83,A10,E1,G11
10_49_84,xcond_1,GRCm39,497,725,1189,496,723,1187,1,2,2,10,49,84,A10,E1,G12
10_49_96,xcond_1,GRCm39,349,531,869,349,531,869,0,0,0,10,49,96,A10,E1,H12
10_50_24,xcond_1,GRCm39,1512,2727,4347,1511,2725,4343,1,2,4,10,50,24,A10,E2,B12
10_50_67,xcond_1,GRCm39,387,534,879,387,534,879,0,0,0,10,50,67,A10,E2,F7
10_50_92,xcond_1,GRCm39,2042,4180,6949,2038,4176,6943,4,4,6,10,50,92,A10,E2,H8
10_51_39,xcond_1,GRCm39,472,664,1072,472,664,1072,0,0,0,10,51,39,A10,E3,D3
10_51_41,xcond_1,GRCm39,379,445,700,377,443,698,2,2,2,10,51,41,A10,E3,D5
10_51_84,xcond_1,GRCm39,608,940,1609,608,940,1609,0,0,0,10,51,84,A10,E3,G12
10_51_90,xcond_1,GRCm39,309,375,618,308,374,615,1,1,3,10,51,90,A10,E3,H6
10_52_52,xcond_1,GRCm39,501,784,1280,500,783,1279,1,1,1,10,52,52,A10,E4,E4
10_52_96,xcond_1,GRCm39,392,596,969,391,595,968,1,1,1,10,52,96,A10,E4,H12
10_53_18,xcond_1,GRCm39,429,745,1225,428,744,1222,1,1,3,10,53,18,A10,E5,B6
10_53_36,xcond_1,GRCm39,1257,2138,3427,1256,2137,3425,1,1,2,10,53,36,A10,E5,C12
10_53_54,xcond_1,GRCm39,430,587,978,430,587,978,0,0,0,10,53,54,A10,E5,E6
10_53_57,xcond_1,GRCm39,224,322,519,223,321,517,1,1,2,10,53,57,A10,E5,E9
10_53_71,xcond_1,GRCm39,706,1016,1679,704,1014,1675,2,2,4,10,53,71,A10,E5,F11
10_53_81,xcond_1,GRCm39,261,316,516,261,316,516,0,0,0,10,53,81,A10,E5,G9
10_53_93,xcond_1,GRCm39,244,337,538,243,336,536,1,1,2,10,53,93,A10,E5,H9
10_54_55,xcond_1,GRCm39,453,702,1143,451,700,1140,2,2,3,10,54,55,A10,E6,E7
10_54_81,xcond_1,GRCm39,271,348,582,270,347,581,1,1,1,10,54,81,A10,E6,G9
10_55_26,xcond_1,GRCm39,188,223,354,186,219,347,2,4,7,10,55,26,A10,E7,C2
10_55_53,xcond_1,GRCm39,326,461,734,325,460,733,1,1,1,10,55,53,A10,E7,E5
10_55_72,xcond_1,GRCm39,167,274,446,167,274,446,0,0,0,10,55,72,A10,E7,F12
10_56_15,xcond_1,GRCm39,1097,2128,3418,1096,2127,3415,1,1,3,10,56,15,A10,E8,B3
10_56_36,xcond_1,GRCm39,733,1013,1656,733,1013,1656,0,0,0,10,56,36,A10,E8,C12
10_56_64,xcond_1,GRCm39,327,494,794,326,492,791,1,2,3,10,56,64,A10,E8,F4
10_56_72,xcond_1,GRCm39,677,1591,2557,675,1583,2542,2,8,15,10,56,72,A10,E8,F12
10_56_73,xcond_1,GRCm39,292,368,588,292,368,588,0,0,0,10,56,73,A10,E8,G1
10_56_80,xcond_1,GRCm39,208,265,428,208,265,428,0,0,0,10,56,80,A10,E8,G8
10_56_84,xcond_1,GRCm39,525,714,1175,524,713,1172,1,1,3,10,56,84,A10,E8,G12
10_56_91,xcond_1,GRCm39,948,1598,2676,945,1595,2671,3,3,5,10,56,91,A10,E8,H7
10_56_93,xcond_1,GRCm39,307,555,908,307,555,908,0,0,0,10,56,93,A10,E8,H9
10_57_04,xcond_1,GRCm39,680,975,1613,679,974,1609,1,1,4,10,57,4,A10,E9,A4
10_57_06,xcond_1,GRCm39,615,2273,3660,615,2273,3660,0,0,0,10,57,6,A10,E9,A6
10_57_31,xcond_1,GRCm39,293,343,551,292,342,550,1,1,1,10,57,31,A10,E9,C7
10_57_59,xcond_1,GRCm39,335,517,811,334,516,809,1,1,2,10,57,59,A10,E9,E11
10_57_90,xcond_1,GRCm39,730,1271,2076,729,1270,2075,1,1,1,10,57,90,A10,E9,H6
10_57_95,xcond_1,GRCm39,600,993,1632,597,990,1629,3,3,3,10,57,95,A10,E9,H11
10_58_06,xcond_1,GRCm39,744,1108,1809,743,1107,1808,1,1,1,10,58,6,A10,E10,A6
10_58_69,xcond_1,GRCm39,490,675,1076,488,673,1073,2,2,3,10,58,69,A10,E10,F9
10_59_04,xcond_1,GRCm39,344,638,1008,342,636,1005,2,2,3,10,59,4,A10,E11,A4
10_59_27,xcond_1,GRCm39,63,215,327,63,215,327,0,0,0,10,59,27,A10,E11,C3
10_59_44,xcond_1,GRCm39,320,395,639,318,393,636,2,2,3,10,59,44,A10,E11,D8
10_59_47,xcond_1,GRCm39,384,482,782,384,482,782,0,0,0,10,59,47,A10,E11,D11
10_59_95,xcond_1,GRCm39,231,373,610,231,373,610,0,0,0,10,59,95,A10,E11,H11
10_60_07,xcond_1,GRCm39,299,413,689,299,413,689,0,0,0,10,60,7,A10,E12,A7
10_60_45,xcond_1,GRCm39,574,817,1346,572,815,1344,2,2,2,10,60,45,A10,E12,D9
10_60_49,xcond_1,GRCm39,550,797,1321,549,796,1320,1,1,1,10,60,49,A10,E12,E1
10_60_73,xcond_1,GRCm39,378,556,915,376,551,906,2,5,9,10,60,73,A10,E12,G1
10_61_16,xcond_1,GRCm39,470,663,1133,470,663,1133,0,0,0,10,61,16,A10,F1,B4
10_61_54,xcond_1,GRCm39,695,1167,1890,694,1166,1889,1,1,1,10,61,54,A10,F1,E6
10_62_08,xcond_1,GRCm39,827,1217,2016,826,1216,2013,1,1,3,10,62,8,A10,F2,A8
10_62_32,xcond_1,GRCm39,400,551,939,399,550,937,1,1,2,10,62,32,A10,F2,C8
10_62_38,xcond_1,GRCm39,845,1401,2333,844,1400,2330,1,1,3,10,62,38,A10,F2,D2
10_63_09,xcond_1,GRCm39,531,772,1236,530,771,1234,1,1,2,10,63,9,A10,F3,A9
10_63_33,xcond_1,GRCm39,292,376,604,291,375,603,1,1,1,10,63,33,A10,F3,C9
10_63_55,xcond_1,GRCm39,1274,2406,3874,1270,2400,3863,4,6,11,10,63,55,A10,F3,E7
10_64_36,xcond_1,GRCm39,304,376,633,304,376,633,0,0,0,10,64,36,A10,F4,C12
10_64_49,xcond_1,GRCm39,369,507,822,369,507,822,0,0,0,10,64,49,A10,F4,E1
10_64_92,xcond_1,GRCm39,590,850,1425,587,847,1421,3,3,4,10,64,92,A10,F4,H8
10_65_06,xcond_1,GRCm39,438,753,1272,437,752,1271,1,1,1,10,65,6,A10,F5,A6
10_65_27,xcond_1,GRCm39,729,1209,1954,729,1209,1954,0,0,0,10,65,27,A10,F5,C3
10_65_32,xcond_1,GRCm39,413,511,823,413,511,823,0,0,0,10,65,32,A10,F5,C8
10_65_48,xcond_1,GRCm39,467,563,917,465,560,911,2,3,6,10,65,48,A10,F5,D12
10_65_51,xcond_1,GRCm39,606,961,1672,606,961,1672,0,0,0,10,65,51,A10,F5,E3
10_66_03,xcond_1,GRCm39,2527,5445,9230,2524,5440,9221,3,5,9,10,66,3,A10,F6,A3
10_66_62,xcond_1,GRCm39,735,1174,1961,734,1173,1960,1,1,1,10,66,62,A10,F6,F2
10_66_71,xcond_1,GRCm39,532,711,1171,531,710,1170,1,1,1,10,66,71,A10,F6,F11
10_67_13,xcond_1,GRCm39,771,1416,2310,768,1413,2305,3,3,5,10,67,13,A10,F7,B1
10_67_15,xcond_1,GRCm39,246,588,973,245,587,972,1,1,1,10,67,15,A10,F7,B3
10_67_23,xcond_1,GRCm39,1067,2041,3293,1067,2041,3293,0,0,0,10,67,23,A10,F7,B11
10_67_28,xcond_1,GRCm39,648,1169,1963,645,1165,1958,3,4,5,10,67,28,A10,F7,C4
10_67_95,xcond_1,GRCm39,608,1046,1739,607,1045,1738,1,1,1,10,67,95,A10,F7,H11
10_68_48,xcond_1,GRCm39,309,375,631,308,374,630,1,1,1,10,68,48,A10,F8,D12
10_68_61,xcond_1,GRCm39,436,677,1109,435,676,1108,1,1,1,10,68,61,A10,F8,F1
10_69_50,xcond_1,GRCm39,396,492,847,395,491,846,1,1,1,10,69,50,A10,F9,E2
10_69_65,xcond_1,GRCm39,649,1074,1715,648,1073,1714,1,1,1,10,69,65,A10,F9,F5
10_71_24,xcond_1,GRCm39,434,579,902,434,579,902,0,0,0,10,71,24,A10,F11,B12
10_71_28,xcond_1,GRCm39,459,672,1125,456,669,1119,3,3,6,10,71,28,A10,F11,C4
10_71_40,xcond_1,GRCm39,355,535,841,352,532,838,3,3,3,10,71,40,A10,F11,D4
10_71_87,xcond_1,GRCm39,495,929,1491,494,928,1490,1,1,1,10,71,87,A10,F11,H3
10_71_90,xcond_1,GRCm39,271,345,569,271,345,569,0,0,0,10,71,90,A10,F11,H6
10_72_28,xcond_1,GRCm39,254,315,506,254,315,506,0,0,0,10,72,28,A10,F12,C4
10_72_72,xcond_1,GRCm39,214,627,1023,214,627,1023,0,0,0,10,72,72,A10,F12,F12
10_72_84,xcond_1,GRCm39,511,1023,1672,511,1023,1672,0,0,0,10,72,84,A10,F12,G12
10_72_85,xcond_1,GRCm39,545,864,1455,544,863,1451,1,1,4,10,72,85,A10,F12,H1
10_73_17,xcond_1,GRCm39,273,357,572,272,356,570,1,1,2,10,73,17,A10,G1,B5
10_73_63,xcond_1,GRCm39,556,781,1275,556,781,1275,0,0,0,10,73,63,A10,G1,F3
10_74_11,xcond_1,GRCm39,168,238,392,168,238,392,0,0,0,10,74,11,A10,G2,A11
10_74_17,xcond_1,GRCm39,259,339,541,259,339,541,0,0,0,10,74,17,A10,G2,B5
10_74_20,xcond_1,GRCm39,1284,2044,3289,1280,2037,3276,4,7,13,10,74,20,A10,G2,B8
10_74_33,xcond_1,GRCm39,757,1330,2121,755,1328,2117,2,2,4,10,74,33,A10,G2,C9
10_74_71,xcond_1,GRCm39,745,1225,2035,743,1223,2033,2,2,2,10,74,71,A10,G2,F11
10_74_73,xcond_1,GRCm39,535,751,1273,535,751,1273,0,0,0,10,74,73,A10,G2,G1
10_74_92,xcond_1,GRCm39,455,648,1050,453,646,1042,2,2,8,10,74,92,A10,G2,H8
10_75_38,xcond_1,GRCm39,520,759,1262,519,758,1261,1,1,1,10,75,38,A10,G3,D2
10_75_74,xcond_1,GRCm39,790,1110,1867,789,1109,1864,1,1,3,10,75,74,A10,G3,G2
10_75_87,xcond_1,GRCm39,870,1716,2800,868,1714,2798,2,2,2,10,75,87,A10,G3,H3
10_76_19,xcond_1,GRCm39,519,762,1198,518,761,1197,1,1,1,10,76,19,A10,G4,B7
10_76_49,xcond_1,GRCm39,849,1928,3070,849,1928,3070,0,0,0,10,76,49,A10,G4,E1
10_76_81,xcond_1,GRCm39,317,383,616,316,382,613,1,1,3,10,76,81,A10,G4,G9
10_77_06,xcond_1,GRCm39,298,411,665,298,411,665,0,0,0,10,77,6,A10,G5,A6
10_77_12,xcond_1,GRCm39,480,756,1235,479,754,1232,1,2,3,10,77,12,A10,G5,A12
10_77_80,xcond_1,GRCm39,637,827,1312,637,827,1312,0,0,0,10,77,80,A10,G5,G8
10_78_12,xcond_1,GRCm39,490,646,1069,489,644,1067,1,2,2,10,78,12,A10,G6,A12
10_78_15,xcond_1,GRCm39,574,922,1576,573,920,1574,1,2,2,10,78,15,A10,G6,B3
10_78_93,xcond_1,GRCm39,234,292,465,234,292,465,0,0,0,10,78,93,A10,G6,H9
10_78_95,xcond_1,GRCm39,965,1619,2621,965,1619,2621,0,0,0,10,78,95,A10,G6,H11
10_79_11,xcond_1,GRCm39,505,647,1075,505,647,1075,0,0,0,10,79,11,A10,G7,A11
10_79_57,xcond_1,GRCm39,282,391,656,282,391,656,0,0,0,10,79,57,A10,G7,E9
10_79_59,xcond_1,GRCm39,627,1018,1610,625,1016,1608,2,2,2,10,79,59,A10,G7,E11
10_79_87,xcond_1,GRCm39,392,577,971,391,576,968,1,1,3,10,79,87,A10,G7,H3
10_80_05,xcond_1,GRCm39,429,528,853,429,528,853,0,0,0,10,80,5,A10,G8,A5
10_80_14,xcond_1,GRCm39,1356,2229,3626,1355,2228,3624,1,1,2,10,80,14,A10,G8,B2
10_80_15,xcond_1,GRCm39,547,731,1190,547,731,1190,0,0,0,10,80,15,A10,G8,B3
10_80_21,xcond_1,GRCm39,335,440,685,335,440,685,0,0,0,10,80,21,A10,G8,B9
10_80_41,xcond_1,GRCm39,813,1164,1829,811,1162,1827,2,2,2,10,80,41,A10,G8,D5
10_80_60,xcond_1,GRCm39,433,734,1127,432,733,1126,1,1,1,10,80,60,A10,G8,E12
10_80_61,xcond_1,GRCm39,528,820,1326,528,820,1326,0,0,0,10,80,61,A10,G8,F1
10_82_24,xcond_1,GRCm39,460,651,1078,458,649,1071,2,2,7,10,82,24,A10,G10,B12
10_82_33,xcond_1,GRCm39,560,880,1450,560,880,1450,0,0,0,10,82,33,A10,G10,C9
10_82_53,xcond_1,GRCm39,258,347,567,258,347,567,0,0,0,10,82,53,A10,G10,E5
10_82_66,xcond_1,GRCm39,470,731,1222,469,730,1221,1,1,1,10,82,66,A10,G10,F6
10_82_78,xcond_1,GRCm39,804,1439,2335,802,1437,2332,2,2,3,10,82,78,A10,G10,G6
10_82_89,xcond_1,GRCm39,1054,1512,2513,1054,1512,2513,0,0,0,10,82,89,A10,G10,H5
10_83_35,xcond_1,GRCm39,253,304,492,253,304,492,0,0,0,10,83,35,A10,G11,C11
10_83_38,xcond_1,GRCm39,203,247,398,203,247,398,0,0,0,10,83,38,A10,G11,D2
10_83_40,xcond_1,GRCm39,307,460,711,307,460,711,0,0,0,10,83,40,A10,G11,D4
10_83_54,xcond_1,GRCm39,607,820,1354,606,818,1352,1,2,2,10,83,54,A10,G11,E6
10_83_67,xcond_1,GRCm39,333,398,618,332,397,616,1,1,2,10,83,67,A10,G11,F7
10_85_14,xcond_1,GRCm39,1091,2119,3420,1091,2119,3420,0,0,0,10,85,14,A10,H1,B2
10_85_44,xcond_1,GRCm39,239,290,484,238,289,483,1,1,1,10,85,44,A10,H1,D8
10_85_57,xcond_1,GRCm39,247,320,498,246,319,495,1,1,3,10,85,57,A10,H1,E9
10_85_61,xcond_1,GRCm39,663,1371,2106,663,1371,2106,0,0,0,10,85,61,A10,H1,F1
10_86_06,xcond_1,GRCm39,583,853,1359,582,852,1357,1,1,2,10,86,6,A10,H2,A6
10_86_27,xcond_1,GRCm39,859,1528,2404,858,1527,2401,1,1,3,10,86,27,A10,H2,C3
10_86_30,xcond_1,GRCm39,269,425,677,269,425,677,0,0,0,10,86,30,A10,H2,C6
10_87_08,xcond_1,GRCm39,169,302,496,168,301,494,1,1,2,10,87,8,A10,H3,A8
10_87_51,xcond_1,GRCm39,382,486,779,382,486,779,0,0,0,10,87,51,A10,H3,E3
10_87_79,xcond_1,GRCm39,1809,4423,7071,1805,4418,7065,4,5,6,10,87,79,A10,H3,G7
10_87_89,xcond_1,GRCm39,564,762,1177,564,762,1177,0,0,0,10,87,89,A10,H3,H5
10_87_96,xcond_1,GRCm39,894,1363,2171,891,1360,2167,3,3,4,10,87,96,A10,H3,H12
10_88_01,xcond_1,GRCm39,609,981,1561,608,980,1558,1,1,3,10,88,1,A10,H4,A1
10_88_37,xcond_1,GRCm39,1216,2063,3415,1214,2061,3413,2,2,2,10,88,37,A10,H4,D1
10_88_40,xcond_1,GRCm39,331,476,756,331,476,756,0,0,0,10,88,40,A10,H4,D4
10_89_23,xcond_1,GRCm39,403,550,908,403,550,908,0,0,0,10,89,23,A10,H5,B11
10_89_59,xcond_1,GRCm39,445,638,1069,445,638,1069,0,0,0,10,89,59,A10,H5,E11
10_89_81,xcond_1,GRCm39,1705,3182,5109,1703,3180,5107,2,2,2,10,89,81,A10,H5,G9
10_89_83,xcond_1,GRCm39,525,847,1341,525,847,1341,0,0,0,10,89,83,A10,H5,G11
10_90_78,xcond_1,GRCm39,681,1054,1794,679,1052,1791,2,2,3,10,90,78,A10,H6,G6
10_90_83,xcond_1,GRCm39,406,576,956,406,576,956,0,0,0,10,90,83,A10,H6,G11
10_90_90,xcond_1,GRCm39,1682,3203,5428,1679,3199,5424,3,4,4,10,90,90,A10,H6,H6
10_91_13,xcond_1,GRCm39,555,871,1405,553,869,1402,2,2,3,10,91,13,A10,H7,B1
10_91_15,xcond_1,GRCm39,523,864,1441,522,863,1440,1,1,1,10,91,15,A10,H7,B3
10_91_18,xcond_1,GRCm39,643,817,1318,642,816,1317,1,1,1,10,91,18,A10,H7,B6
10_91_37,xcond_1,GRCm39,711,1110,1811,710,1109,1810,1,1,1,10,91,37,A10,H7,D1
10_91_71,xcond_1,GRCm39,509,901,1482,509,901,1482,0,0,0,10,91,71,A10,H7,F11
10_91_87,xcond_1,GRCm39,281,363,584,281,363,584,0,0,0,10,91,87,A10,H7,H3
10_91_89,xcond_1,GRCm39,405,534,883,404,533,880,1,1,3,10,91,89,A10,H7,H5
10_91_93,xcond_1,GRCm39,355,437,721,355,437,721,0,0,0,10,91,93,A10,H7,H9
10_92_08,xcond_1,GRCm39,344,468,780,343,467,779,1,1,1,10,92,8,A10,H8,A8
10_92_14,xcond_1,GRCm39,1449,2536,4280,1449,2536,4280,0,0,0,10,92,14,A10,H8,B2
10_92_28,xcond_1,GRCm39,371,483,792,371,483,792,0,0,0,10,92,28,A10,H8,C4
10_92_38,xcond_1,GRCm39,734,997,1627,730,992,1620,4,5,7,10,92,38,A10,H8,D2
10_92_43,xcond_1,GRCm39,286,405,665,285,404,664,1,1,1,10,92,43,A10,H8,D7
10_92_95,xcond_1,GRCm39,353,554,882,353,554,882,0,0,0,10,92,95,A10,H8,H11
10_93_06,xcond_1,GRCm39,797,1119,1891,796,1118,1890,1,1,1,10,93,6,A10,H9,A6
10_93_29,xcond_1,GRCm39,480,640,994,480,640,994,0,0,0,10,93,29,A10,H9,C5
10_93_44,xcond_1,GRCm39,439,639,1048,438,638,1047,1,1,1,10,93,44,A10,H9,D8
10_93_47,xcond_1,GRCm39,283,386,601,283,386,601,0,0,0,10,93,47,A10,H9,D11
10_93_91,xcond_1,GRCm39,391,597,1033,389,594,1028,2,3,5,10,93,91,A10,H9,H7
10_94_17,xcond_1,GRCm39,699,1299,2102,696,1295,2098,3,4,4,10,94,17,A10,H10,B5
10_94_42,xcond_1,GRCm39,475,637,1051,474,636,1046,1,1,5,10,94,42,A10,H10,D6
10_94_60,xcond_1,GRCm39,879,1654,2614,878,1653,2613,1,1,1,10,94,60,A10,H10,E12
10_94_91,xcond_1,GRCm39,775,1155,1958,774,1154,1957,1,1,1,10,94,91,A10,H10,H7
10_94_93,xcond_1,GRCm39,280,374,614,280,374,614,0,0,0,10,94,93,A10,H10,H9
10_95_03,xcond_1,GRCm39,465,723,1192,463,720,1187,2,3,5,10,95,3,A10,H11,A3
10_95_27,xcond_1,GRCm39,431,578,941,431,578,941,0,0,0,10,95,27,A10,H11,C3
10_95_30,xcond_1,GRCm39,601,796,1350,601,796,1350,0,0,0,10,95,30,A10,H11,C6
10_95_44,xcond_1,GRCm39,359,461,783,359,461,783,0,0,0,10,95,44,A10,H11,D8
10_95_69,xcond_1,GRCm39,255,309,521,255,309,521,0,0,0,10,95,69,A10,H11,F9
10_95_74,xcond_1,GRCm39,443,655,1105,443,655,1105,0,0,0,10,95,74,A10,H11,G2
10_95_75,xcond_1,GRCm39,503,695,1173,503,695,1173,0,0,0,10,95,75,A10,H11,G3
11_01_16,xcond_1,GRCm39,1816,3236,5184,1813,3233,5181,3,3,3,11,1,16,A11,A1,B4
11_01_69,xcond_1,GRCm39,1345,2202,3537,1341,2198,3532,4,4,5,11,1,69,A11,A1,F9
11_01_75,xcond_1,GRCm39,694,1300,2157,693,1298,2155,1,2,2,11,1,75,A11,A1,G3
11_01_91,xcond_1,GRCm39,1106,2101,3476,1105,2100,3475,1,1,1,11,1,91,A11,A1,H7
11_02_57,xcond_1,GRCm39,434,580,968,434,580,968,0,0,0,11,2,57,A11,A2,E9
11_02_59,xcond_1,GRCm39,612,894,1435,612,894,1435,0,0,0,11,2,59,A11,A2,E11
11_03_59,xcond_1,GRCm39,397,508,797,397,508,797,0,0,0,11,3,59,A11,A3,E11
11_03_86,xcond_1,GRCm39,606,829,1303,606,829,1303,0,0,0,11,3,86,A11,A3,H2
11_03_91,xcond_1,GRCm39,365,470,784,363,468,782,2,2,2,11,3,91,A11,A3,H7
11_04_08,xcond_1,GRCm39,1328,2681,4314,1324,2676,4309,4,5,5,11,4,8,A11,A4,A8
11_04_30,xcond_1,GRCm39,766,1456,2388,766,1456,2388,0,0,0,11,4,30,A11,A4,C6
11_04_49,xcond_1,GRCm39,443,699,1101,442,698,1099,1,1,2,11,4,49,A11,A4,E1
11_04_73,xcond_1,GRCm39,655,958,1568,655,958,1568,0,0,0,11,4,73,A11,A4,G1
11_04_80,xcond_1,GRCm39,822,1350,2158,820,1346,2152,2,4,6,11,4,80,A11,A4,G8
11_05_09,xcond_1,GRCm39,440,550,876,440,550,876,0,0,0,11,5,9,A11,A5,A9
11_05_16,xcond_1,GRCm39,1912,3890,6288,1909,3885,6283,3,5,5,11,5,16,A11,A5,B4
11_05_72,xcond_1,GRCm39,1384,2346,3984,1382,2343,3978,2,3,6,11,5,72,A11,A5,F12
11_05_80,xcond_1,GRCm39,346,418,667,346,418,667,0,0,0,11,5,80,A11,A5,G8
11_06_12,xcond_1,GRCm39,839,1197,1924,838,1196,1921,1,1,3,11,6,12,A11,A6,A12
11_06_87,xcond_1,GRCm39,584,898,1470,583,897,1468,1,1,2,11,6,87,A11,A6,H3
11_07_07,xcond_1,GRCm39,808,1196,1958,808,1196,1958,0,0,0,11,7,7,A11,A7,A7
11_07_18,xcond_1,GRCm39,256,303,473,256,303,473,0,0,0,11,7,18,A11,A7,B6
11_08_66,xcond_1,GRCm39,669,919,1577,669,919,1577,0,0,0,11,8,66,A11,A8,F6
11_08_81,xcond_1,GRCm39,872,1273,2029,870,1271,2027,2,2,2,11,8,81,A11,A8,G9
11_09_01,xcond_1,GRCm39,421,648,1055,421,648,1055,0,0,0,11,9,1,A11,A9,A1
11_09_03,xcond_1,GRCm39,727,1256,2035,725,1252,2030,2,4,5,11,9,3,A11,A9,A3
11_09_52,xcond_1,GRCm39,1533,2987,4913,1532,2986,4910,1,1,3,11,9,52,A11,A9,E4
11_09_59,xcond_1,GRCm39,1385,2600,4197,1384,2598,4195,1,2,2,11,9,59,A11,A9,E11
11_09_84,xcond_1,GRCm39,905,1551,2473,904,1550,2472,1,1,1,11,9,84,A11,A9,G12
11_10_08,xcond_1,GRCm39,848,1486,2397,848,1486,2397,0,0,0,11,10,8,A11,A10,A8
11_10_26,xcond_1,GRCm39,183,213,331,183,213,331,0,0,0,11,10,26,A11,A10,C2
11_10_36,xcond_1,GRCm39,665,896,1429,664,895,1422,1,1,7,11,10,36,A11,A10,C12
11_10_38,xcond_1,GRCm39,196,230,367,196,230,367,0,0,0,11,10,38,A11,A10,D2
11_10_44,xcond_1,GRCm39,379,473,728,379,473,728,0,0,0,11,10,44,A11,A10,D8
11_10_45,xcond_1,GRCm39,350,479,760,350,479,760,0,0,0,11,10,45,A11,A10,D9
11_10_54,xcond_1,GRCm39,399,548,895,399,548,895,0,0,0,11,10,54,A11,A10,E6
11_10_63,xcond_1,GRCm39,231,352,559,230,351,558,1,1,1,11,10,63,A11,A10,F3
11_11_21,xcond_1,GRCm39,389,558,859,389,558,859,0,0,0,11,11,21,A11,A11,B9
11_11_91,xcond_1,GRCm39,860,1339,2115,859,1338,2114,1,1,1,11,11,91,A11,A11,H7
11_12_07,xcond_1,GRCm39,395,598,951,395,598,951,0,0,0,11,12,7,A11,A12,A7
11_12_30,xcond_1,GRCm39,581,877,1408,580,876,1407,1,1,1,11,12,30,A11,A12,C6
11_12_51,xcond_1,GRCm39,707,1166,1856,706,1165,1855,1,1,1,11,12,51,A11,A12,E3
11_12_54,xcond_1,GRCm39,362,474,785,362,474,785,0,0,0,11,12,54,A11,A12,E6
11_12_71,xcond_1,GRCm39,539,750,1215,539,750,1215,0,0,0,11,12,71,A11,A12,F11
11_12_72,xcond_1,GRCm39,266,477,762,266,477,762,0,0,0,11,12,72,A11,A12,F12
11_12_93,xcond_1,GRCm39,384,514,824,384,514,824,0,0,0,11,12,93,A11,A12,H9
11_14_33,xcond_1,GRCm39,610,858,1371,610,858,1371,0,0,0,11,14,33,A11,B2,C9
11_14_56,xcond_1,GRCm39,785,1165,1858,784,1164,1857,1,1,1,11,14,56,A11,B2,E8
11_15_02,xcond_1,GRCm39,716,987,1569,714,985,1567,2,2,2,11,15,2,A11,B3,A2
11_15_05,xcond_1,GRCm39,1310,3266,5324,1307,3262,5318,3,4,6,11,15,5,A11,B3,A5
11_15_12,xcond_1,GRCm39,419,576,918,418,575,917,1,1,1,11,15,12,A11,B3,A12
11_16_45,xcond_1,GRCm39,933,1584,2582,932,1583,2581,1,1,1,11,16,45,A11,B4,D9
11_16_49,xcond_1,GRCm39,1156,1869,3013,1154,1867,3011,2,2,2,11,16,49,A11,B4,E1
11_16_64,xcond_1,GRCm39,249,302,444,249,302,444,0,0,0,11,16,64,A11,B4,F4
11_16_68,xcond_1,GRCm39,828,1315,2144,827,1314,2143,1,1,1,11,16,68,A11,B4,F8
11_16_86,xcond_1,GRCm39,641,890,1481,640,889,1480,1,1,1,11,16,86,A11,B4,H2
11_17_08,xcond_1,GRCm39,252,315,490,252,315,490,0,0,0,11,17,8,A11,B5,A8
11_17_38,xcond_1,GRCm39,1489,3106,5194,1488,3105,5193,1,1,1,11,17,38,A11,B5,D2
11_17_72,xcond_1,GRCm39,416,582,988,416,582,988,0,0,0,11,17,72,A11,B5,F12
11_17_73,xcond_1,GRCm39,108,313,514,108,313,514,0,0,0,11,17,73,A11,B5,G1
11_17_90,xcond_1,GRCm39,1038,1913,3113,1037,1912,3111,1,1,2,11,17,90,A11,B5,H6
11_18_09,xcond_1,GRCm39,363,468,735,363,468,735,0,0,0,11,18,9,A11,B6,A9
11_18_67,xcond_1,GRCm39,597,897,1428,595,894,1423,2,3,5,11,18,67,A11,B6,F7
11_18_68,xcond_1,GRCm39,1467,2577,4221,1466,2575,4216,1,2,5,11,18,68,A11,B6,F8
11_19_35,xcond_1,GRCm39,1673,3470,5574,1671,3467,5571,2,3,3,11,19,35,A11,B7,C11
11_19_74,xcond_1,GRCm39,844,1502,2472,843,1501,2471,1,1,1,11,19,74,A11,B7,G2
11_19_96,xcond_1,GRCm39,1808,3619,5873,1807,3618,5872,1,1,1,11,19,96,A11,B7,H12
11_20_15,xcond_1,GRCm39,417,860,1351,417,860,1351,0,0,0,11,20,15,A11,B8,B3
11_20_40,xcond_1,GRCm39,788,1220,1924,788,1220,1924,0,0,0,11,20,40,A11,B8,D4
11_20_42,xcond_1,GRCm39,2230,4641,7392,2229,4638,7388,1,3,4,11,20,42,A11,B8,D6
11_20_67,xcond_1,GRCm39,974,1879,2897,973,1878,2896,1,1,1,11,20,67,A11,B8,F7
11_20_73,xcond_1,GRCm39,2594,5567,8838,2591,5564,8835,3,3,3,11,20,73,A11,B8,G1
11_20_95,xcond_1,GRCm39,2840,6504,10478,2837,6494,10461,3,10,17,11,20,95,A11,B8,H11
11_21_33,xcond_1,GRCm39,310,375,600,309,374,598,1,1,2,11,21,33,A11,B9,C9
11_21_45,xcond_1,GRCm39,290,345,560,290,345,560,0,0,0,11,21,45,A11,B9,D9
11_22_06,xcond_1,GRCm39,568,772,1236,566,769,1233,2,3,3,11,22,6,A11,B10,A6
11_22_09,xcond_1,GRCm39,398,496,822,398,496,822,0,0,0,11,22,9,A11,B10,A9
11_22_77,xcond_1,GRCm39,1617,3026,4837,1613,3022,4830,4,4,7,11,22,77,A11,B10,G5
11_23_38,xcond_1,GRCm39,734,1187,1963,734,1187,1963,0,0,0,11,23,38,A11,B11,D2
11_23_61,xcond_1,GRCm39,1966,3940,6328,1965,3939,6325,1,1,3,11,23,61,A11,B11,F1
11_24_02,xcond_1,GRCm39,1487,2584,4212,1485,2582,4208,2,2,4,11,24,2,A11,B12,A2
11_24_05,xcond_1,GRCm39,2958,7253,12008,2955,7249,11999,3,4,9,11,24,5,A11,B12,A5
11_24_36,xcond_1,GRCm39,539,748,1197,537,746,1195,2,2,2,11,24,36,A11,B12,C12
11_24_69,xcond_1,GRCm39,676,1114,1829,675,1113,1828,1,1,1,11,24,69,A11,B12,F9
11_25_27,xcond_1,GRCm39,180,222,338,180,222,338,0,0,0,11,25,27,A11,C1,C3
11_25_69,xcond_1,GRCm39,224,284,462,223,283,460,1,1,2,11,25,69,A11,C1,F9
11_25_76,xcond_1,GRCm39,869,1348,2192,867,1346,2188,2,2,4,11,25,76,A11,C1,G4
11_26_66,xcond_1,GRCm39,207,229,352,207,229,352,0,0,0,11,26,66,A11,C2,F6
11_26_71,xcond_1,GRCm39,277,364,611,276,363,610,1,1,1,11,26,71,A11,C2,F11
11_26_83,xcond_1,GRCm39,175,442,732,174,441,731,1,1,1,11,26,83,A11,C2,G11
11_26_84,xcond_1,GRCm39,783,1196,1958,781,1193,1954,2,3,4,11,26,84,A11,C2,G12
11_26_92,xcond_1,GRCm39,679,1178,1939,677,1176,1936,2,2,3,11,26,92,A11,C2,H8
11_27_07,xcond_1,GRCm39,1033,1535,2407,1031,1533,2405,2,2,2,11,27,7,A11,C3,A7
11_27_08,xcond_1,GRCm39,720,1146,1869,720,1146,1869,0,0,0,11,27,8,A11,C3,A8
11_27_79,xcond_1,GRCm39,1344,2604,4266,1343,2603,4265,1,1,1,11,27,79,A11,C3,G7
11_28_29,xcond_1,GRCm39,593,907,1458,593,907,1458,0,0,0,11,28,29,A11,C4,C5
11_28_36,xcond_1,GRCm39,1087,1767,2809,1086,1766,2808,1,1,1,11,28,36,A11,C4,C12
11_28_44,xcond_1,GRCm39,1244,1963,3212,1243,1962,3210,1,1,2,11,28,44,A11,C4,D8
11_28_45,xcond_1,GRCm39,779,1252,2030,779,1252,2030,0,0,0,11,28,45,A11,C4,D9
11_28_66,xcond_1,GRCm39,847,1439,2343,846,1438,2340,1,1,3,11,28,66,A11,C4,F6
11_29_39,xcond_1,GRCm39,982,1635,2638,981,1634,2637,1,1,1,11,29,39,A11,C5,D3
11_29_69,xcond_1,GRCm39,206,240,382,206,240,382,0,0,0,11,29,69,A11,C5,F9
11_29_77,xcond_1,GRCm39,1360,2461,4089,1359,2460,4087,1,1,2,11,29,77,A11,C5,G5
11_29_78,xcond_1,GRCm39,2487,6266,10163,2484,6258,10152,3,8,11,11,29,78,A11,C5,G6
11_30_16,xcond_1,GRCm39,299,376,587,298,375,586,1,1,1,11,30,16,A11,C6,B4
11_30_20,xcond_1,GRCm39,772,1223,1943,771,1222,1942,1,1,1,11,30,20,A11,C6,B8
11_31_35,xcond_1,GRCm39,399,653,1074,398,652,1073,1,1,1,11,31,35,A11,C7,C11
11_31_63,xcond_1,GRCm39,796,1297,2059,795,1296,2058,1,1,1,11,31,63,A11,C7,F3
11_32_17,xcond_1,GRCm39,2427,4954,8080,2425,4952,8077,2,2,3,11,32,17,A11,C8,B5
11_32_48,xcond_1,GRCm39,914,1597,2596,914,1597,2596,0,0,0,11,32,48,A11,C8,D12
11_32_50,xcond_1,GRCm39,569,791,1305,569,791,1305,0,0,0,11,32,50,A11,C8,E2
11_32_83,xcond_1,GRCm39,734,1089,1809,733,1088,1805,1,1,4,11,32,83,A11,C8,G11
11_32_84,xcond_1,GRCm39,276,344,505,275,343,504,1,1,1,11,32,84,A11,C8,G12
11_32_91,xcond_1,GRCm39,1138,1932,3182,1137,1931,3179,1,1,3,11,32,91,A11,C8,H7
11_33_20,xcond_1,GRCm39,900,1731,2760,899,1728,2755,1,3,5,11,33,20,A11,C9,B8
11_33_57,xcond_1,GRCm39,275,350,591,274,349,590,1,1,1,11,33,57,A11,C9,E9
11_33_64,xcond_1,GRCm39,1198,2159,3485,1197,2158,3482,1,1,3,11,33,64,A11,C9,F4
11_33_84,xcond_1,GRCm39,325,852,1339,324,851,1338,1,1,1,11,33,84,A11,C9,G12
11_34_09,xcond_1,GRCm39,275,339,565,275,339,565,0,0,0,11,34,9,A11,C10,A9
11_34_63,xcond_1,GRCm39,535,724,1141,533,722,1139,2,2,2,11,34,63,A11,C10,F3
11_34_86,xcond_1,GRCm39,749,1186,2036,746,1182,2031,3,4,5,11,34,86,A11,C10,H2
11_34_92,xcond_1,GRCm39,1006,1788,2902,1004,1786,2898,2,2,4,11,34,92,A11,C10,H8
11_34_96,xcond_1,GRCm39,411,538,861,410,537,859,1,1,2,11,34,96,A11,C10,H12
11_35_28,xcond_1,GRCm39,2379,5268,8464,2376,5263,8456,3,5,8,11,35,28,A11,C11,C4
11_35_73,xcond_1,GRCm39,817,1384,2232,817,1384,2232,0,0,0,11,35,73,A11,C11,G1
11_35_75,xcond_1,GRCm39,933,1343,2175,931,1341,2171,2,2,4,11,35,75,A11,C11,G3
11_35_84,xcond_1,GRCm39,632,969,1577,630,967,1573,2,2,4,11,35,84,A11,C11,G12
11_36_28,xcond_1,GRCm39,1337,2621,4184,1334,2618,4181,3,3,3,11,36,28,A11,C12,C4
11_36_42,xcond_1,GRCm39,324,374,583,324,374,583,0,0,0,11,36,42,A11,C12,D6
11_36_52,xcond_1,GRCm39,413,549,790,413,549,790,0,0,0,11,36,52,A11,C12,E4
11_36_55,xcond_1,GRCm39,443,625,1006,443,625,1006,0,0,0,11,36,55,A11,C12,E7
11_36_72,xcond_1,GRCm39,444,649,1039,442,646,1035,2,3,4,11,36,72,A11,C12,F12
11_36_93,xcond_1,GRCm39,288,369,593,288,369,593,0,0,0,11,36,93,A11,C12,H9
11_37_12,xcond_1,GRCm39,860,1222,2105,859,1221,2102,1,1,3,11,37,12,A11,D1,A12
11_37_31,xcond_1,GRCm39,757,1073,1792,756,1072,1789,1,1,3,11,37,31,A11,D1,C7
11_37_41,xcond_1,GRCm39,648,883,1462,646,881,1460,2,2,2,11,37,41,A11,D1,D5
11_37_49,xcond_1,GRCm39,999,1955,3240,999,1955,3240,0,0,0,11,37,49,A11,D1,E1
11_37_86,xcond_1,GRCm39,226,291,445,226,291,445,0,0,0,11,37,86,A11,D1,H2
11_38_06,xcond_1,GRCm39,437,587,949,437,587,949,0,0,0,11,38,6,A11,D2,A6
11_38_20,xcond_1,GRCm39,1933,4249,6881,1930,4246,6876,3,3,5,11,38,20,A11,D2,B8
11_38_30,xcond_1,GRCm39,1797,3415,5636,1797,3415,5636,0,0,0,11,38,30,A11,D2,C6
11_38_37,xcond_1,GRCm39,4409,13704,22368,4401,13691,22349,8,13,19,11,38,37,A11,D2,D1
11_38_44,xcond_1,GRCm39,465,665,1074,464,664,1073,1,1,1,11,38,44,A11,D2,D8
11_39_45,xcond_1,GRCm39,287,342,559,287,342,559,0,0,0,11,39,45,A11,D3,D9
11_39_57,xcond_1,GRCm39,384,514,802,383,513,800,1,1,2,11,39,57,A11,D3,E9
11_39_96,xcond_1,GRCm39,730,1128,1871,728,1126,1867,2,2,4,11,39,96,A11,D3,H12
11_40_03,xcond_1,GRCm39,830,1400,2312,829,1399,2310,1,1,2,11,40,3,A11,D4,A3
11_40_15,xcond_1,GRCm39,1226,2132,3536,1225,2131,3535,1,1,1,11,40,15,A11,D4,B3
11_40_32,xcond_1,GRCm39,724,1024,1637,723,1023,1636,1,1,1,11,40,32,A11,D4,C8
11_40_40,xcond_1,GRCm39,2685,6158,10014,2682,6154,10010,3,4,4,11,40,40,A11,D4,D4
11_40_43,xcond_1,GRCm39,927,1494,2476,927,1494,2476,0,0,0,11,40,43,A11,D4,D7
11_40_76,xcond_1,GRCm39,443,577,923,443,577,923,0,0,0,11,40,76,A11,D4,G4
11_41_23,xcond_1,GRCm39,1903,4070,6707,1900,4066,6703,3,4,4,11,41,23,A11,D5,B11
11_41_30,xcond_1,GRCm39,865,1460,2350,865,1460,2350,0,0,0,11,41,30,A11,D5,C6
11_41_60,xcond_1,GRCm39,1028,1613,2692,1027,1612,2690,1,1,2,11,41,60,A11,D5,E12
11_42_55,xcond_1,GRCm39,745,1094,1745,743,1092,1743,2,2,2,11,42,55,A11,D6,E7
11_42_61,xcond_1,GRCm39,670,934,1468,670,934,1468,0,0,0,11,42,61,A11,D6,F1
11_42_66,xcond_1,GRCm39,684,1123,1806,684,1123,1806,0,0,0,11,42,66,A11,D6,F6
11_42_76,xcond_1,GRCm39,724,1109,1752,723,1108,1750,1,1,2,11,42,76,A11,D6,G4
11_42_83,xcond_1,GRCm39,1590,2780,4541,1588,2778,4538,2,2,3,11,42,83,A11,D6,G11
11_43_30,xcond_1,GRCm39,492,642,1036,490,640,1033,2,2,3,11,43,30,A11,D7,C6
11_43_41,xcond_1,GRCm39,511,705,1123,510,704,1121,1,1,2,11,43,41,A11,D7,D5
11_43_57,xcond_1,GRCm39,288,359,555,287,358,554,1,1,1,11,43,57,A11,D7,E9
11_44_40,xcond_1,GRCm39,1767,3482,5569,1763,3478,5564,4,4,5,11,44,40,A11,D8,D4
11_44_54,xcond_1,GRCm39,1197,1904,3039,1197,1904,3039,0,0,0,11,44,54,A11,D8,E6
11_44_55,xcond_1,GRCm39,2051,3819,6178,2048,3814,6173,3,5,5,11,44,55,A11,D8,E7
11_45_14,xcond_1,GRCm39,1026,1828,2973,1025,1827,2969,1,1,4,11,45,14,A11,D9,B2
11_45_31,xcond_1,GRCm39,739,1125,1821,738,1123,1818,1,2,3,11,45,31,A11,D9,C7
11_45_39,xcond_1,GRCm39,1295,2298,3687,1294,2295,3683,1,3,4,11,45,39,A11,D9,D3
11_45_59,xcond_1,GRCm39,599,808,1284,598,807,1283,1,1,1,11,45,59,A11,D9,E11
11_45_69,xcond_1,GRCm39,1051,1568,2524,1049,1566,2522,2,2,2,11,45,69,A11,D9,F9
11_45_86,xcond_1,GRCm39,1834,3985,6707,1831,3978,6697,3,7,10,11,45,86,A11,D9,H2
11_45_91,xcond_1,GRCm39,2117,4615,7628,2112,4608,7620,5,7,8,11,45,91,A11,D9,H7
11_46_72,xcond_1,GRCm39,4182,11496,19053,4178,11487,19040,4,9,13,11,46,72,A11,D10,F12
11_48_45,xcond_1,GRCm39,458,669,1076,455,666,1072,3,3,4,11,48,45,A11,D12,D9
11_48_95,xcond_1,GRCm39,1127,1897,3054,1122,1892,3048,5,5,6,11,48,95,A11,D12,H11
11_49_09,xcond_1,GRCm39,348,507,838,348,507,838,0,0,0,11,49,9,A11,E1,A9
11_49_42,xcond_1,GRCm39,1627,2828,4678,1625,2825,4672,2,3,6,11,49,42,A11,E1,D6
11_49_43,xcond_1,GRCm39,862,1537,2432,860,1535,2430,2,2,2,11,49,43,A11,E1,D7
11_49_55,xcond_1,GRCm39,1000,1564,2451,1000,1564,2451,0,0,0,11,49,55,A11,E1,E7
11_50_13,xcond_1,GRCm39,389,627,953,389,627,953,0,0,0,11,50,13,A11,E2,B1
11_50_16,xcond_1,GRCm39,1154,2056,3316,1153,2055,3315,1,1,1,11,50,16,A11,E2,B4
11_50_17,xcond_1,GRCm39,587,886,1405,587,886,1405,0,0,0,11,50,17,A11,E2,B5
11_50_62,xcond_1,GRCm39,1593,3011,4926,1590,3006,4919,3,5,7,11,50,62,A11,E2,F2
11_50_69,xcond_1,GRCm39,945,1639,2656,942,1635,2652,3,4,4,11,50,69,A11,E2,F9
11_51_25,xcond_1,GRCm39,542,808,1316,541,807,1313,1,1,3,11,51,25,A11,E3,C1
11_51_30,xcond_1,GRCm39,367,508,791,367,508,791,0,0,0,11,51,30,A11,E3,C6
11_51_33,xcond_1,GRCm39,325,408,685,325,408,685,0,0,0,11,51,33,A11,E3,C9
11_51_36,xcond_1,GRCm39,554,914,1565,554,914,1565,0,0,0,11,51,36,A11,E3,C12
11_51_41,xcond_1,GRCm39,605,792,1267,605,792,1267,0,0,0,11,51,41,A11,E3,D5
11_51_53,xcond_1,GRCm39,330,443,739,330,443,739,0,0,0,11,51,53,A11,E3,E5
11_51_80,xcond_1,GRCm39,380,516,840,380,516,840,0,0,0,11,51,80,A11,E3,G8
11_52_31,xcond_1,GRCm39,1390,2560,4035,1386,2555,4029,4,5,6,11,52,31,A11,E4,C7
11_52_71,xcond_1,GRCm39,657,1125,1803,656,1124,1802,1,1,1,11,52,71,A11,E4,F11
11_52_74,xcond_1,GRCm39,809,1359,2219,809,1359,2219,0,0,0,11,52,74,A11,E4,G2
11_53_32,xcond_1,GRCm39,971,1653,2619,970,1652,2617,1,1,2,11,53,32,A11,E5,C8
11_53_37,xcond_1,GRCm39,1930,3950,6484,1928,3947,6480,2,3,4,11,53,37,A11,E5,D1
11_53_43,xcond_1,GRCm39,1449,2484,4025,1449,2484,4025,0,0,0,11,53,43,A11,E5,D7
11_53_88,xcond_1,GRCm39,1226,2055,3271,1223,2051,3264,3,4,7,11,53,88,A11,E5,H4
11_54_12,xcond_1,GRCm39,774,1225,2038,771,1222,2035,3,3,3,11,54,12,A11,E6,A12
11_54_40,xcond_1,GRCm39,346,427,675,345,426,673,1,1,2,11,54,40,A11,E6,D4
11_54_44,xcond_1,GRCm39,605,843,1371,605,843,1371,0,0,0,11,54,44,A11,E6,D8
11_54_48,xcond_1,GRCm39,583,921,1543,583,921,1543,0,0,0,11,54,48,A11,E6,D12
11_54_57,xcond_1,GRCm39,324,446,759,324,446,759,0,0,0,11,54,57,A11,E6,E9
11_54_81,xcond_1,GRCm39,827,1218,2026,827,1218,2026,0,0,0,11,54,81,A11,E6,G9
11_54_83,xcond_1,GRCm39,663,1041,1734,662,1040,1733,1,1,1,11,54,83,A11,E6,G11
11_54_85,xcond_1,GRCm39,276,332,543,276,332,543,0,0,0,11,54,85,A11,E6,H1
11_55_01,xcond_1,GRCm39,1325,2491,4071,1323,2489,4069,2,2,2,11,55,1,A11,E7,A1
11_55_26,xcond_1,GRCm39,486,862,1471,485,861,1467,1,1,4,11,55,26,A11,E7,C2
11_55_68,xcond_1,GRCm39,702,1215,1996,701,1214,1995,1,1,1,11,55,68,A11,E7,F8
11_56_16,xcond_1,GRCm39,698,1141,1836,697,1140,1835,1,1,1,11,56,16,A11,E8,B4
11_56_43,xcond_1,GRCm39,194,226,334,194,226,334,0,0,0,11,56,43,A11,E8,D7
11_56_51,xcond_1,GRCm39,1160,2205,3577,1159,2204,3573,1,1,4,11,56,51,A11,E8,E3
11_56_71,xcond_1,GRCm39,195,607,982,195,607,982,0,0,0,11,56,71,A11,E8,F11
11_57_20,xcond_1,GRCm39,1250,2027,3287,1249,2025,3285,1,2,2,11,57,20,A11,E9,B8
11_57_28,xcond_1,GRCm39,504,846,1408,504,846,1408,0,0,0,11,57,28,A11,E9,C4
11_57_57,xcond_1,GRCm39,577,953,1574,576,952,1573,1,1,1,11,57,57,A11,E9,E9
11_57_73,xcond_1,GRCm39,87,210,333,87,210,333,0,0,0,11,57,73,A11,E9,G1
11_57_88,xcond_1,GRCm39,971,1594,2590,970,1593,2588,1,1,2,11,57,88,A11,E9,H4
11_58_04,xcond_1,GRCm39,780,1281,2064,779,1279,2062,1,2,2,11,58,4,A11,E10,A4
11_58_19,xcond_1,GRCm39,563,818,1341,561,815,1335,2,3,6,11,58,19,A11,E10,B7
11_58_93,xcond_1,GRCm39,672,906,1429,671,905,1428,1,1,1,11,58,93,A11,E10,H9
11_59_31,xcond_1,GRCm39,1047,1643,2604,1045,1641,2602,2,2,2,11,59,31,A11,E11,C7
11_59_38,xcond_1,GRCm39,1192,2182,3449,1191,2181,3448,1,1,1,11,59,38,A11,E11,D2
11_59_43,xcond_1,GRCm39,611,912,1454,611,912,1454,0,0,0,11,59,43,A11,E11,D7
11_59_76,xcond_1,GRCm39,1261,2484,3941,1259,2480,3937,2,4,4,11,59,76,A11,E11,G4
11_59_86,xcond_1,GRCm39,723,1092,1748,723,1092,1748,0,0,0,11,59,86,A11,E11,H2
11_60_20,xcond_1,GRCm39,822,1120,1897,820,1118,1895,2,2,2,11,60,20,A11,E12,B8
11_61_04,xcond_1,GRCm39,657,1050,1782,655,1048,1779,2,2,3,11,61,4,A11,F1,A4
11_61_36,xcond_1,GRCm39,1794,3458,5600,1793,3456,5598,1,2,2,11,61,36,A11,F1,C12
11_61_50,xcond_1,GRCm39,981,1655,2687,980,1654,2686,1,1,1,11,61,50,A11,F1,E2
11_61_96,xcond_1,GRCm39,758,1197,1932,758,1197,1932,0,0,0,11,61,96,A11,F1,H12
11_62_15,xcond_1,GRCm39,1037,1915,3244,1035,1913,3242,2,2,2,11,62,15,A11,F2,B3
11_62_86,xcond_1,GRCm39,190,444,748,190,444,748,0,0,0,11,62,86,A11,F2,H2
11_63_04,xcond_1,GRCm39,2030,4856,7957,2029,4853,7948,1,3,9,11,63,4,A11,F3,A4
11_63_21,xcond_1,GRCm39,386,544,868,385,543,867,1,1,1,11,63,21,A11,F3,B9
11_63_37,xcond_1,GRCm39,912,1755,2783,911,1754,2782,1,1,1,11,63,37,A11,F3,D1
11_63_81,xcond_1,GRCm39,877,1546,2502,876,1545,2501,1,1,1,11,63,81,A11,F3,G9
11_64_15,xcond_1,GRCm39,1099,1840,3064,1098,1839,3063,1,1,1,11,64,15,A11,F4,B3
11_64_26,xcond_1,GRCm39,874,1584,2639,872,1582,2637,2,2,2,11,64,26,A11,F4,C2
11_64_35,xcond_1,GRCm39,504,638,1030,504,638,1030,0,0,0,11,64,35,A11,F4,C11
11_64_50,xcond_1,GRCm39,716,1045,1784,716,1045,1784,0,0,0,11,64,50,A11,F4,E2
11_64_61,xcond_1,GRCm39,584,794,1274,584,794,1274,0,0,0,11,64,61,A11,F4,F1
11_64_64,xcond_1,GRCm39,340,742,1198,340,742,1198,0,0,0,11,64,64,A11,F4,F4
11_64_72,xcond_1,GRCm39,531,746,1243,531,746,1243,0,0,0,11,64,72,A11,F4,F12
11_64_81,xcond_1,GRCm39,582,850,1413,582,850,1413,0,0,0,11,64,81,A11,F4,G9
11_65_18,xcond_1,GRCm39,877,1617,2702,877,1617,2702,0,0,0,11,65,18,A11,F5,B6
11_65_57,xcond_1,GRCm39,814,1146,1921,814,1146,1921,0,0,0,11,65,57,A11,F5,E9
11_65_61,xcond_1,GRCm39,162,284,458,162,284,458,0,0,0,11,65,61,A11,F5,F1
11_65_72,xcond_1,GRCm39,1414,2435,4211,1413,2433,4209,1,2,2,11,65,72,A11,F5,F12
11_65_96,xcond_1,GRCm39,1231,2065,3464,1230,2064,3462,1,1,2,11,65,96,A11,F5,H12
11_66_16,xcond_1,GRCm39,764,1148,1918,764,1148,1918,0,0,0,11,66,16,A11,F6,B4
11_66_24,xcond_1,GRCm39,1139,1819,3022,1137,1817,3018,2,2,4,11,66,24,A11,F6,B12
11_66_28,xcond_1,GRCm39,629,1111,1828,626,1107,1823,3,4,5,11,66,28,A11,F6,C4
11_66_52,xcond_1,GRCm39,718,1272,2090,717,1271,2088,1,1,2,11,66,52,A11,F6,E4
11_66_66,xcond_1,GRCm39,1035,1942,3292,1034,1941,3291,1,1,1,11,66,66,A11,F6,F6
11_66_67,xcond_1,GRCm39,1461,2450,4166,1459,2448,4163,2,2,3,11,66,67,A11,F6,F7
11_67_21,xcond_1,GRCm39,560,762,1219,560,762,1219,0,0,0,11,67,21,A11,F7,B9
11_67_32,xcond_1,GRCm39,291,378,620,290,377,619,1,1,1,11,67,32,A11,F7,C8
11_67_44,xcond_1,GRCm39,865,1535,2553,864,1534,2550,1,1,3,11,67,44,A11,F7,D8
11_67_52,xcond_1,GRCm39,951,1606,2609,947,1602,2602,4,4,7,11,67,52,A11,F7,E4
11_68_36,xcond_1,GRCm39,575,891,1396,575,891,1396,0,0,0,11,68,36,A11,F8,C12
11_68_51,xcond_1,GRCm39,493,642,1058,492,641,1057,1,1,1,11,68,51,A11,F8,E3
11_68_57,xcond_1,GRCm39,361,449,733,361,449,733,0,0,0,11,68,57,A11,F8,E9
11_68_62,xcond_1,GRCm39,734,1196,1999,733,1195,1998,1,1,1,11,68,62,A11,F8,F2
11_69_41,xcond_1,GRCm39,212,274,368,211,273,367,1,1,1,11,69,41,A11,F9,D5
11_69_51,xcond_1,GRCm39,903,1605,2599,901,1603,2592,2,2,7,11,69,51,A11,F9,E3
11_69_63,xcond_1,GRCm39,451,680,1092,451,680,1092,0,0,0,11,69,63,A11,F9,F3
11_69_80,xcond_1,GRCm39,1222,2580,4190,1221,2579,4189,1,1,1,11,69,80,A11,F9,G8
11_69_93,xcond_1,GRCm39,377,506,799,376,505,797,1,1,2,11,69,93,A11,F9,H9
11_70_29,xcond_1,GRCm39,183,208,343,183,208,343,0,0,0,11,70,29,A11,F10,C5
11_70_81,xcond_1,GRCm39,442,708,1170,441,707,1169,1,1,1,11,70,81,A11,F10,G9
11_71_14,xcond_1,GRCm39,758,1295,2098,758,1295,2098,0,0,0,11,71,14,A11,F11,B2
11_71_43,xcond_1,GRCm39,495,721,1204,495,721,1204,0,0,0,11,71,43,A11,F11,D7
11_71_90,xcond_1,GRCm39,590,921,1440,588,917,1435,2,4,5,11,71,90,A11,F11,H6
11_73_30,xcond_1,GRCm39,620,904,1480,620,904,1480,0,0,0,11,73,30,A11,G1,C6
11_73_77,xcond_1,GRCm39,906,1278,2085,906,1278,2085,0,0,0,11,73,77,A11,G1,G5
11_73_84,xcond_1,GRCm39,799,1704,2830,798,1702,2827,1,2,3,11,73,84,A11,G1,G12
11_74_08,xcond_1,GRCm39,789,1198,1890,788,1197,1889,1,1,1,11,74,8,A11,G2,A8
11_74_24,xcond_1,GRCm39,729,1022,1711,729,1022,1711,0,0,0,11,74,24,A11,G2,B12
11_74_96,xcond_1,GRCm39,1165,1791,2987,1163,1789,2984,2,2,3,11,74,96,A11,G2,H12
11_75_14,xcond_1,GRCm39,589,884,1365,588,883,1364,1,1,1,11,75,14,A11,G3,B2
11_75_25,xcond_1,GRCm39,1763,3110,5145,1762,3109,5144,1,1,1,11,75,25,A11,G3,C1
11_75_50,xcond_1,GRCm39,389,528,907,389,528,907,0,0,0,11,75,50,A11,G3,E2
11_75_83,xcond_1,GRCm39,484,629,1056,483,628,1055,1,1,1,11,75,83,A11,G3,G11
11_76_04,xcond_1,GRCm39,581,961,1514,580,960,1512,1,1,2,11,76,4,A11,G4,A4
11_77_11,xcond_1,GRCm39,985,1782,2782,984,1780,2779,1,2,3,11,77,11,A11,G5,A11
11_77_18,xcond_1,GRCm39,350,422,644,350,422,644,0,0,0,11,77,18,A11,G5,B6
11_77_44,xcond_1,GRCm39,854,1284,2050,852,1281,2047,2,3,3,11,77,44,A11,G5,D8
11_77_72,xcond_1,GRCm39,423,667,1118,423,667,1118,0,0,0,11,77,72,A11,G5,F12
11_77_93,xcond_1,GRCm39,192,244,380,192,244,380,0,0,0,11,77,93,A11,G5,H9
11_78_16,xcond_1,GRCm39,244,336,512,244,336,512,0,0,0,11,78,16,A11,G6,B4
11_78_25,xcond_1,GRCm39,550,793,1266,550,793,1266,0,0,0,11,78,25,A11,G6,C1
11_78_44,xcond_1,GRCm39,686,1072,1757,685,1071,1755,1,1,2,11,78,44,A11,G6,D8
11_78_48,xcond_1,GRCm39,780,1173,1897,778,1171,1894,2,2,3,11,78,48,A11,G6,D12
11_79_50,xcond_1,GRCm39,2521,4807,8152,2520,4806,8151,1,1,1,11,79,50,A11,G7,E2
11_79_60,xcond_1,GRCm39,928,1402,2334,927,1401,2333,1,1,1,11,79,60,A11,G7,E12
11_79_65,xcond_1,GRCm39,524,808,1374,523,807,1373,1,1,1,11,79,65,A11,G7,F5
11_80_13,xcond_1,GRCm39,1640,3133,5072,1637,3130,5069,3,3,3,11,80,13,A11,G8,B1
11_80_21,xcond_1,GRCm39,621,817,1374,619,815,1371,2,2,3,11,80,21,A11,G8,B9
11_81_36,xcond_1,GRCm39,782,1174,1849,780,1171,1845,2,3,4,11,81,36,A11,G9,C12
11_81_69,xcond_1,GRCm39,479,647,1004,479,647,1004,0,0,0,11,81,69,A11,G9,F9
11_82_15,xcond_1,GRCm39,1035,1800,2848,1034,1799,2847,1,1,1,11,82,15,A11,G10,B3
11_82_40,xcond_1,GRCm39,1555,2842,4652,1555,2842,4652,0,0,0,11,82,40,A11,G10,D4
11_82_62,xcond_1,GRCm39,1146,2024,3224,1146,2024,3224,0,0,0,11,82,62,A11,G10,F2
11_82_66,xcond_1,GRCm39,689,931,1515,687,929,1512,2,2,3,11,82,66,A11,G10,F6
11_83_05,xcond_1,GRCm39,560,848,1391,559,847,1390,1,1,1,11,83,5,A11,G11,A5
11_83_33,xcond_1,GRCm39,288,407,644,288,407,644,0,0,0,11,83,33,A11,G11,C9
11_83_67,xcond_1,GRCm39,292,379,633,292,379,633,0,0,0,11,83,67,A11,G11,F7
11_85_11,xcond_1,GRCm39,3071,7512,12020,3065,7504,12012,6,8,8,11,85,11,A11,H1,A11
11_85_29,xcond_1,GRCm39,656,1072,1670,656,1072,1670,0,0,0,11,85,29,A11,H1,C5
11_85_48,xcond_1,GRCm39,930,1610,2514,929,1609,2513,1,1,1,11,85,48,A11,H1,D12
11_85_49,xcond_1,GRCm39,1620,2932,4713,1619,2929,4710,1,3,3,11,85,49,A11,H1,E1
11_85_68,xcond_1,GRCm39,559,1180,1823,559,1180,1823,0,0,0,11,85,68,A11,H1,F8
11_85_89,xcond_1,GRCm39,732,1188,1910,731,1187,1908,1,1,2,11,85,89,A11,H1,H5
11_86_08,xcond_1,GRCm39,608,846,1368,608,846,1368,0,0,0,11,86,8,A11,H2,A8
11_86_09,xcond_1,GRCm39,182,218,343,181,217,336,1,1,7,11,86,9,A11,H2,A9
11_86_47,xcond_1,GRCm39,2059,3980,6430,2057,3978,6427,2,2,3,11,86,47,A11,H2,D11
11_86_96,xcond_1,GRCm39,495,736,1147,495,736,1147,0,0,0,11,86,96,A11,H2,H12
11_87_19,xcond_1,GRCm39,350,410,671,350,410,671,0,0,0,11,87,19,A11,H3,B7
11_87_31,xcond_1,GRCm39,3777,9444,14996,3774,9434,14984,3,10,12,11,87,31,A11,H3,C7
11_87_49,xcond_1,GRCm39,1066,1741,2692,1063,1737,2684,3,4,8,11,87,49,A11,H3,E1
11_87_52,xcond_1,GRCm39,997,1868,3016,994,1865,3012,3,3,4,11,87,52,A11,H3,E4
11_88_19,xcond_1,GRCm39,894,1524,2415,894,1524,2415,0,0,0,11,88,19,A11,H4,B7
11_88_31,xcond_1,GRCm39,529,828,1290,529,828,1290,0,0,0,11,88,31,A11,H4,C7
11_88_33,xcond_1,GRCm39,700,1130,1799,699,1129,1798,1,1,1,11,88,33,A11,H4,C9
11_89_23,xcond_1,GRCm39,3098,7264,11777,3093,7256,11764,5,8,13,11,89,23,A11,H5,B11
11_89_36,xcond_1,GRCm39,794,1280,1973,793,1279,1972,1,1,1,11,89,36,A11,H5,C12
11_89_88,xcond_1,GRCm39,908,1410,2226,905,1406,2222,3,4,4,11,89,88,A11,H5,H4
11_90_09,xcond_1,GRCm39,1141,2000,3395,1138,1997,3388,3,3,7,11,90,9,A11,H6,A9
11_90_39,xcond_1,GRCm39,1966,3460,5786,1965,3459,5784,1,1,2,11,90,39,A11,H6,D3
11_90_44,xcond_1,GRCm39,191,231,360,191,231,360,0,0,0,11,90,44,A11,H6,D8
11_90_57,xcond_1,GRCm39,301,398,633,300,397,632,1,1,1,11,90,57,A11,H6,E9
11_90_62,xcond_1,GRCm39,346,444,717,344,442,713,2,2,4,11,90,62,A11,H6,F2
11_91_09,xcond_1,GRCm39,1543,2739,4479,1543,2739,4479,0,0,0,11,91,9,A11,H7,A9
11_91_16,xcond_1,GRCm39,526,707,1108,526,707,1108,0,0,0,11,91,16,A11,H7,B4
11_91_21,xcond_1,GRCm39,560,908,1461,559,907,1459,1,1,2,11,91,21,A11,H7,B9
11_91_27,xcond_1,GRCm39,1185,3566,5616,1183,3563,5610,2,3,6,11,91,27,A11,H7,C3
11_91_28,xcond_1,GRCm39,912,1675,2755,912,1675,2755,0,0,0,11,91,28,A11,H7,C4
11_91_37,xcond_1,GRCm39,3244,8238,13370,3241,8233,13363,3,5,7,11,91,37,A11,H7,D1
11_91_45,xcond_1,GRCm39,930,1487,2431,928,1485,2428,2,2,3,11,91,45,A11,H7,D9
11_91_83,xcond_1,GRCm39,1623,4380,7206,1619,4374,7190,4,6,16,11,91,83,A11,H7,G11
11_91_92,xcond_1,GRCm39,760,1057,1722,759,1056,1721,1,1,1,11,91,92,A11,H7,H8
11_92_02,xcond_1,GRCm39,548,856,1377,546,853,1374,2,3,3,11,92,2,A11,H8,A2
11_92_11,xcond_1,GRCm39,1672,3135,5063,1671,3134,5062,1,1,1,11,92,11,A11,H8,A11
11_92_39,xcond_1,GRCm39,993,1763,2819,992,1762,2818,1,1,1,11,92,39,A11,H8,D3
11_92_42,xcond_1,GRCm39,471,645,1031,470,644,1029,1,1,2,11,92,42,A11,H8,D6
11_92_50,xcond_1,GRCm39,660,995,1679,659,993,1675,1,2,4,11,92,50,A11,H8,E2
11_93_42,xcond_1,GRCm39,2871,6516,10593,2866,6508,10581,5,8,12,11,93,42,A11,H9,D6
11_93_66,xcond_1,GRCm39,651,1060,1798,651,1060,1798,0,0,0,11,93,66,A11,H9,F6
11_94_02,xcond_1,GRCm39,409,580,941,408,579,939,1,1,2,11,94,2,A11,H10,A2
11_94_26,xcond_1,GRCm39,438,597,973,438,597,973,0,0,0,11,94,26,A11,H10,C2
11_94_33,xcond_1,GRCm39,1495,2576,4271,1494,2574,4269,1,2,2,11,94,33,A11,H10,C9
11_94_41,xcond_1,GRCm39,147,267,423,146,266,420,1,1,3,11,94,41,A11,H10,D5
11_94_61,xcond_1,GRCm39,645,1026,1700,644,1025,1698,1,1,2,11,94,61,A11,H10,F1
11_94_80,xcond_1,GRCm39,496,653,1036,496,653,1036,0,0,0,11,94,80,A11,H10,G8
11_94_96,xcond_1,GRCm39,1578,3433,5575,1578,3433,5575,0,0,0,11,94,96,A11,H10,H12
11_95_12,xcond_1,GRCm39,724,1081,1819,723,1080,1817,1,1,2,11,95,12,A11,H11,A12
11_95_79,xcond_1,GRCm39,536,841,1339,534,839,1335,2,2,4,11,95,79,A11,H11,G7
11_96_81,xcond_1,GRCm39,540,718,1239,540,718,1239,0,0,0,11,96,81,A11,H12,G9
12_01_17,xcond_1,GRCm39,1155,2089,3367,1155,2089,3367,0,0,0,12,1,17,A12,A1,B5
12_01_37,xcond_1,GRCm39,1935,3966,6508,1932,3963,6504,3,3,4,12,1,37,A12,A1,D1
12_01_43,xcond_1,GRCm39,1891,4794,7568,1888,4791,7562,3,3,6,12,1,43,A12,A1,D7
12_01_56,xcond_1,GRCm39,1026,1667,2711,1025,1665,2709,1,2,2,12,1,56,A12,A1,E8
12_01_64,xcond_1,GRCm39,1309,2862,4529,1308,2861,4527,1,1,2,12,1,64,A12,A1,F4
12_01_73,xcond_1,GRCm39,777,1174,1819,776,1173,1817,1,1,2,12,1,73,A12,A1,G1
12_02_60,xcond_1,GRCm39,1866,3941,6387,1864,3939,6384,2,2,3,12,2,60,A12,A2,E12
12_02_96,xcond_1,GRCm39,669,919,1473,668,917,1469,1,2,4,12,2,96,A12,A2,H12
12_03_07,xcond_1,GRCm39,220,289,460,219,288,457,1,1,3,12,3,7,A12,A3,A7
12_03_33,xcond_1,GRCm39,328,427,696,327,426,694,1,1,2,12,3,33,A12,A3,C9
12_03_41,xcond_1,GRCm39,169,206,316,168,205,314,1,1,2,12,3,41,A12,A3,D5
12_03_48,xcond_1,GRCm39,1035,1851,2928,1034,1850,2927,1,1,1,12,3,48,A12,A3,D12
12_03_69,xcond_1,GRCm39,544,753,1189,544,753,1189,0,0,0,12,3,69,A12,A3,F9
12_04_21,xcond_1,GRCm39,4040,11283,18311,4034,11276,18300,6,7,11,12,4,21,A12,A4,B9
12_04_25,xcond_1,GRCm39,749,1262,2038,746,1259,2034,3,3,4,12,4,25,A12,A4,C1
12_04_37,xcond_1,GRCm39,1584,3054,4901,1584,3054,4901,0,0,0,12,4,37,A12,A4,D1
12_04_59,xcond_1,GRCm39,1194,2567,4045,1191,2563,4040,3,4,5,12,4,59,A12,A4,E11
12_04_69,xcond_1,GRCm39,250,324,509,250,324,509,0,0,0,12,4,69,A12,A4,F9
12_04_86,xcond_1,GRCm39,1764,3526,5718,1763,3525,5717,1,1,1,12,4,86,A12,A4,H2
12_04_96,xcond_1,GRCm39,3258,7040,11392,3253,7033,11378,5,7,14,12,4,96,A12,A4,H12
12_05_03,xcond_1,GRCm39,588,755,1219,587,754,1217,1,1,2,12,5,3,A12,A5,A3
12_05_14,xcond_1,GRCm39,1905,3718,5875,1901,3713,5870,4,5,5,12,5,14,A12,A5,B2
12_05_24,xcond_1,GRCm39,4218,12746,20193,4214,12739,20186,4,7,7,12,5,24,A12,A5,B12
12_05_90,xcond_1,GRCm39,113,354,522,113,354,522,0,0,0,12,5,90,A12,A5,H6
12_06_21,xcond_1,GRCm39,783,1159,1888,783,1159,1888,0,0,0,12,6,21,A12,A6,B9
12_06_40,xcond_1,GRCm39,1121,1813,2900,1118,1808,2893,3,5,7,12,6,40,A12,A6,D4
12_06_60,xcond_1,GRCm39,427,578,915,426,577,914,1,1,1,12,6,60,A12,A6,E12
12_06_66,xcond_1,GRCm39,798,1524,2446,798,1524,2446,0,0,0,12,6,66,A12,A6,F6
12_06_69,xcond_1,GRCm39,479,654,1069,479,654,1069,0,0,0,12,6,69,A12,A6,F9
12_06_88,xcond_1,GRCm39,1459,2893,4771,1458,2892,4770,1,1,1,12,6,88,A12,A6,H4
12_07_09,xcond_1,GRCm39,431,578,932,431,578,932,0,0,0,12,7,9,A12,A7,A9
12_07_13,xcond_1,GRCm39,1187,1909,3007,1186,1908,3006,1,1,1,12,7,13,A12,A7,B1
12_07_27,xcond_1,GRCm39,164,207,283,164,207,283,0,0,0,12,7,27,A12,A7,C3
12_07_31,xcond_1,GRCm39,585,801,1270,585,801,1270,0,0,0,12,7,31,A12,A7,C7
12_07_41,xcond_1,GRCm39,822,1451,2344,822,1451,2344,0,0,0,12,7,41,A12,A7,D5
12_07_57,xcond_1,GRCm39,639,964,1547,639,964,1547,0,0,0,12,7,57,A12,A7,E9
12_07_66,xcond_1,GRCm39,393,518,797,393,518,797,0,0,0,12,7,66,A12,A7,F6
12_07_95,xcond_1,GRCm39,1525,2910,4807,1525,2910,4807,0,0,0,12,7,95,A12,A7,H11
12_07_96,xcond_1,GRCm39,2802,6188,9895,2801,6187,9893,1,1,2,12,7,96,A12,A7,H12
12_08_13,xcond_1,GRCm39,559,804,1212,558,803,1211,1,1,1,12,8,13,A12,A8,B1
12_08_36,xcond_1,GRCm39,4478,13308,20982,4470,13293,20955,8,15,27,12,8,36,A12,A8,C12
12_08_69,xcond_1,GRCm39,795,1189,1860,795,1189,1860,0,0,0,12,8,69,A12,A8,F9
12_09_26,xcond_1,GRCm39,1402,2665,4286,1401,2664,4285,1,1,1,12,9,26,A12,A9,C2
12_09_60,xcond_1,GRCm39,1778,3297,5334,1778,3297,5334,0,0,0,12,9,60,A12,A9,E12
12_09_84,xcond_1,GRCm39,941,1351,2208,938,1348,2205,3,3,3,12,9,84,A12,A9,G12
12_10_32,xcond_1,GRCm39,228,296,478,228,296,478,0,0,0,12,10,32,A12,A10,C8
12_10_49,xcond_1,GRCm39,1046,1949,3085,1045,1948,3084,1,1,1,12,10,49,A12,A10,E1
12_10_92,xcond_1,GRCm39,613,1007,1623,612,1006,1621,1,1,2,12,10,92,A12,A10,H8
12_10_96,xcond_1,GRCm39,3080,8259,13068,3077,8253,13062,3,6,6,12,10,96,A12,A10,H12
12_11_40,xcond_1,GRCm39,1202,2042,3136,1201,2041,3134,1,1,2,12,11,40,A12,A11,D4
12_11_89,xcond_1,GRCm39,1156,1747,2714,1156,1747,2714,0,0,0,12,11,89,A12,A11,H5
12_12_05,xcond_1,GRCm39,661,1097,1745,660,1096,1744,1,1,1,12,12,5,A12,A12,A5
12_12_87,xcond_1,GRCm39,539,773,1204,539,773,1204,0,0,0,12,12,87,A12,A12,H3
12_12_90,xcond_1,GRCm39,1021,1639,2564,1019,1637,2561,2,2,3,12,12,90,A12,A12,H6
12_13_06,xcond_1,GRCm39,683,1113,1830,681,1110,1826,2,3,4,12,13,6,A12,B1,A6
12_13_13,xcond_1,GRCm39,795,1315,2139,794,1314,2137,1,1,2,12,13,13,A12,B1,B1
12_13_20,xcond_1,GRCm39,2800,6785,10912,2797,6780,10906,3,5,6,12,13,20,A12,B1,B8
12_13_25,xcond_1,GRCm39,2036,4174,6619,2033,4170,6614,3,4,5,12,13,25,A12,B1,C1
12_13_45,xcond_1,GRCm39,2115,4200,6787,2112,4195,6780,3,5,7,12,13,45,A12,B1,D9
12_13_69,xcond_1,GRCm39,302,391,595,300,389,592,2,2,3,12,13,69,A12,B1,F9
12_13_78,xcond_1,GRCm39,179,227,334,179,227,334,0,0,0,12,13,78,A12,B1,G6
12_14_20,xcond_1,GRCm39,1200,2128,3405,1199,2127,3403,1,1,2,12,14,20,A12,B2,B8
12_14_23,xcond_1,GRCm39,1220,2370,3683,1218,2368,3679,2,2,4,12,14,23,A12,B2,B11
12_14_63,xcond_1,GRCm39,334,421,680,334,421,680,0,0,0,12,14,63,A12,B2,F3
12_14_74,xcond_1,GRCm39,472,651,999,472,651,999,0,0,0,12,14,74,A12,B2,G2
12_15_32,xcond_1,GRCm39,395,645,1026,394,644,1024,1,1,2,12,15,32,A12,B3,C8
12_15_36,xcond_1,GRCm39,1087,1889,3052,1085,1887,3050,2,2,2,12,15,36,A12,B3,C12
12_15_61,xcond_1,GRCm39,1048,1555,2536,1048,1555,2536,0,0,0,12,15,61,A12,B3,F1
12_15_87,xcond_1,GRCm39,4828,15365,24490,4823,15353,24472,5,12,18,12,15,87,A12,B3,H3
12_16_64,xcond_1,GRCm39,2659,6150,9842,2657,6143,9832,2,7,10,12,16,64,A12,B4,F4
12_16_69,xcond_1,GRCm39,827,1413,2246,827,1413,2246,0,0,0,12,16,69,A12,B4,F9
12_17_08,xcond_1,GRCm39,1151,1990,3239,1148,1986,3234,3,4,5,12,17,8,A12,B5,A8
12_17_13,xcond_1,GRCm39,1963,3470,5605,1962,3469,5604,1,1,1,12,17,13,A12,B5,B1
12_17_44,xcond_1,GRCm39,3439,10801,17414,3436,10794,17405,3,7,9,12,17,44,A12,B5,D8
12_18_13,xcond_1,GRCm39,168,286,409,168,286,409,0,0,0,12,18,13,A12,B6,B1
12_18_37,xcond_1,GRCm39,2194,4915,7786,2191,4912,7783,3,3,3,12,18,37,A12,B6,D1
12_18_42,xcond_1,GRCm39,928,1569,2472,928,1569,2472,0,0,0,12,18,42,A12,B6,D6
12_18_60,xcond_1,GRCm39,1648,3356,5249,1644,3350,5241,4,6,8,12,18,60,A12,B6,E12
12_18_65,xcond_1,GRCm39,1244,2176,3549,1242,2174,3546,2,2,3,12,18,65,A12,B6,F5
12_18_69,xcond_1,GRCm39,529,727,1148,529,727,1148,0,0,0,12,18,69,A12,B6,F9
12_19_11,xcond_1,GRCm39,1266,2392,3785,1266,2392,3785,0,0,0,12,19,11,A12,B7,A11
12_19_14,xcond_1,GRCm39,790,1256,1970,790,1256,1970,0,0,0,12,19,14,A12,B7,B2
12_19_16,xcond_1,GRCm39,1520,3258,5228,1520,3258,5228,0,0,0,12,19,16,A12,B7,B4
12_19_30,xcond_1,GRCm39,905,1332,2143,904,1331,2139,1,1,4,12,19,30,A12,B7,C6
12_19_33,xcond_1,GRCm39,507,748,1188,506,747,1187,1,1,1,12,19,33,A12,B7,C9
12_19_55,xcond_1,GRCm39,1178,2147,3371,1175,2144,3368,3,3,3,12,19,55,A12,B7,E7
12_19_68,xcond_1,GRCm39,573,1400,2234,571,1398,2232,2,2,2,12,19,68,A12,B7,F8
12_19_81,xcond_1,GRCm39,782,1272,2061,782,1272,2061,0,0,0,12,19,81,A12,B7,G9
12_19_93,xcond_1,GRCm39,618,919,1483,617,918,1482,1,1,1,12,19,93,A12,B7,H9
12_20_59,xcond_1,GRCm39,1327,2647,4205,1325,2642,4200,2,5,5,12,20,59,A12,B8,E11
12_20_80,xcond_1,GRCm39,616,923,1429,616,923,1429,0,0,0,12,20,80,A12,B8,G8
12_20_85,xcond_1,GRCm39,326,448,736,326,448,736,0,0,0,12,20,85,A12,B8,H1
12_20_96,xcond_1,GRCm39,2303,5188,8231,2299,5183,8224,4,5,7,12,20,96,A12,B8,H12
12_21_60,xcond_1,GRCm39,527,813,1276,527,813,1276,0,0,0,12,21,60,A12,B9,E12
12_21_88,xcond_1,GRCm39,647,1001,1637,647,1001,1637,0,0,0,12,21,88,A12,B9,H4
12_21_96,xcond_1,GRCm39,1019,1605,2558,1016,1600,2550,3,5,8,12,21,96,A12,B9,H12
12_22_72,xcond_1,GRCm39,2580,6656,11016,2579,6655,11014,1,1,2,12,22,72,A12,B10,F12
12_22_96,xcond_1,GRCm39,1396,2503,3939,1394,2501,3937,2,2,2,12,22,96,A12,B10,H12
12_23_52,xcond_1,GRCm39,882,1473,2366,880,1471,2362,2,2,4,12,23,52,A12,B11,E4
12_24_40,xcond_1,GRCm39,659,797,1288,659,797,1288,0,0,0,12,24,40,A12,B12,D4
12_24_69,xcond_1,GRCm39,3639,9427,15123,3636,9424,15119,3,3,4,12,24,69,A12,B12,F9
12_25_03,xcond_1,GRCm39,335,433,704,334,432,703,1,1,1,12,25,3,A12,C1,A3
12_25_54,xcond_1,GRCm39,613,1078,1692,612,1077,1690,1,1,2,12,25,54,A12,C1,E6
12_25_79,xcond_1,GRCm39,1884,3914,6412,1884,3914,6412,0,0,0,12,25,79,A12,C1,G7
12_26_15,xcond_1,GRCm39,665,1100,1804,664,1099,1803,1,1,1,12,26,15,A12,C2,B3
12_26_19,xcond_1,GRCm39,715,1149,1864,714,1148,1863,1,1,1,12,26,19,A12,C2,B7
12_26_81,xcond_1,GRCm39,596,792,1321,595,791,1320,1,1,1,12,26,81,A12,C2,G9
12_26_90,xcond_1,GRCm39,91,352,536,91,352,536,0,0,0,12,26,90,A12,C2,H6
12_26_96,xcond_1,GRCm39,967,1423,2329,966,1422,2327,1,1,2,12,26,96,A12,C2,H12
12_27_08,xcond_1,GRCm39,1591,2837,4503,1590,2835,4501,1,2,2,12,27,8,A12,C3,A8
12_27_14,xcond_1,GRCm39,1283,2330,3726,1281,2327,3723,2,3,3,12,27,14,A12,C3,B2
12_27_27,xcond_1,GRCm39,161,213,307,161,213,307,0,0,0,12,27,27,A12,C3,C3
12_27_28,xcond_1,GRCm39,775,1246,1958,773,1244,1956,2,2,2,12,27,28,A12,C3,C4
12_27_43,xcond_1,GRCm39,960,1666,2658,957,1663,2653,3,3,5,12,27,43,A12,C3,D7
12_27_74,xcond_1,GRCm39,1103,1973,3113,1101,1969,3107,2,4,6,12,27,74,A12,C3,G2
12_27_79,xcond_1,GRCm39,1754,4752,7643,1751,4749,7639,3,3,4,12,27,79,A12,C3,G7
12_27_90,xcond_1,GRCm39,321,393,594,321,393,594,0,0,0,12,27,90,A12,C3,H6
12_28_04,xcond_1,GRCm39,572,869,1350,571,868,1349,1,1,1,12,28,4,A12,C4,A4
12_28_57,xcond_1,GRCm39,810,1448,2274,809,1447,2273,1,1,1,12,28,57,A12,C4,E9
12_28_62,xcond_1,GRCm39,1008,1612,2583,1006,1610,2581,2,2,2,12,28,62,A12,C4,F2
12_28_66,xcond_1,GRCm39,578,750,1200,577,749,1199,1,1,1,12,28,66,A12,C4,F6
12_28_80,xcond_1,GRCm39,2542,5027,8122,2539,5023,8117,3,4,5,12,28,80,A12,C4,G8
12_29_07,xcond_1,GRCm39,386,515,808,386,515,808,0,0,0,12,29,7,A12,C5,A7
12_29_16,xcond_1,GRCm39,676,1023,1634,676,1023,1634,0,0,0,12,29,16,A12,C5,B4
12_29_36,xcond_1,GRCm39,1842,3162,5178,1837,3155,5167,5,7,11,12,29,36,A12,C5,C12
12_29_60,xcond_1,GRCm39,287,352,567,287,352,567,0,0,0,12,29,60,A12,C5,E12
12_29_69,xcond_1,GRCm39,569,780,1255,569,780,1255,0,0,0,12,29,69,A12,C5,F9
12_29_75,xcond_1,GRCm39,215,290,457,215,290,457,0,0,0,12,29,75,A12,C5,G3
12_29_78,xcond_1,GRCm39,845,1503,2384,843,1501,2381,2,2,3,12,29,78,A12,C5,G6
12_30_05,xcond_1,GRCm39,434,593,949,433,592,948,1,1,1,12,30,5,A12,C6,A5
12_30_09,xcond_1,GRCm39,488,732,1210,485,729,1207,3,3,3,12,30,9,A12,C6,A9
12_30_17,xcond_1,GRCm39,463,605,949,463,605,949,0,0,0,12,30,17,A12,C6,B5
12_30_26,xcond_1,GRCm39,364,546,886,364,546,886,0,0,0,12,30,26,A12,C6,C2
12_30_68,xcond_1,GRCm39,383,517,837,383,517,837,0,0,0,12,30,68,A12,C6,F8
12_30_69,xcond_1,GRCm39,332,432,677,332,432,677,0,0,0,12,30,69,A12,C6,F9
12_30_74,xcond_1,GRCm39,670,1062,1720,669,1059,1717,1,3,3,12,30,74,A12,C6,G2
12_30_83,xcond_1,GRCm39,107,270,415,107,270,415,0,0,0,12,30,83,A12,C6,G11
12_31_23,xcond_1,GRCm39,300,845,1334,300,845,1334,0,0,0,12,31,23,A12,C7,B11
12_31_28,xcond_1,GRCm39,1483,2835,4512,1482,2833,4509,1,2,3,12,31,28,A12,C7,C4
12_31_73,xcond_1,GRCm39,532,743,1220,530,741,1218,2,2,2,12,31,73,A12,C7,G1
12_31_80,xcond_1,GRCm39,1012,1767,2756,1012,1767,2756,0,0,0,12,31,80,A12,C7,G8
12_32_03,xcond_1,GRCm39,1122,1985,3243,1120,1981,3238,2,4,5,12,32,3,A12,C8,A3
12_32_08,xcond_1,GRCm39,648,915,1423,647,914,1422,1,1,1,12,32,8,A12,C8,A8
12_32_56,xcond_1,GRCm39,1447,3503,5633,1446,3500,5629,1,3,4,12,32,56,A12,C8,E8
12_32_57,xcond_1,GRCm39,1063,2372,3836,1062,2371,3835,1,1,1,12,32,57,A12,C8,E9
12_32_63,xcond_1,GRCm39,1098,1671,2677,1094,1667,2671,4,4,6,12,32,63,A12,C8,F3
12_32_69,xcond_1,GRCm39,929,1488,2488,929,1488,2488,0,0,0,12,32,69,A12,C8,F9
12_32_84,xcond_1,GRCm39,1136,1727,2663,1135,1726,2662,1,1,1,12,32,84,A12,C8,G12
12_32_86,xcond_1,GRCm39,819,1233,2037,819,1233,2037,0,0,0,12,32,86,A12,C8,H2
12_33_45,xcond_1,GRCm39,1421,2248,3629,1418,2245,3623,3,3,6,12,33,45,A12,C9,D9
12_33_54,xcond_1,GRCm39,344,532,834,344,532,834,0,0,0,12,33,54,A12,C9,E6
12_33_89,xcond_1,GRCm39,502,878,1372,500,876,1370,2,2,2,12,33,89,A12,C9,H5
12_34_45,xcond_1,GRCm39,1075,1904,3091,1074,1903,3090,1,1,1,12,34,45,A12,C10,D9
12_34_49,xcond_1,GRCm39,1529,2464,4039,1527,2461,4036,2,3,3,12,34,49,A12,C10,E1
12_34_64,xcond_1,GRCm39,3410,8820,14123,3408,8811,14107,2,9,16,12,34,64,A12,C10,F4
12_35_85,xcond_1,GRCm39,1049,1668,2609,1049,1668,2609,0,0,0,12,35,85,A12,C11,H1
12_36_03,xcond_1,GRCm39,418,533,884,418,533,884,0,0,0,12,36,3,A12,C12,A3
12_36_07,xcond_1,GRCm39,466,688,1056,466,688,1056,0,0,0,12,36,7,A12,C12,A7
12_36_31,xcond_1,GRCm39,293,413,631,290,410,626,3,3,5,12,36,31,A12,C12,C7
12_36_47,xcond_1,GRCm39,2400,5863,9226,2397,5859,9222,3,4,4,12,36,47,A12,C12,D11
12_36_52,xcond_1,GRCm39,441,600,855,441,600,855,0,0,0,12,36,52,A12,C12,E4
12_36_64,xcond_1,GRCm39,999,1750,2767,998,1749,2766,1,1,1,12,36,64,A12,C12,F4
12_36_71,xcond_1,GRCm39,757,1056,1671,756,1055,1669,1,1,2,12,36,71,A12,C12,F11
12_36_85,xcond_1,GRCm39,2537,5913,9416,2533,5906,9406,4,7,10,12,36,85,A12,C12,H1
12_37_07,xcond_1,GRCm39,2739,7120,11578,2735,7115,11569,4,5,9,12,37,7,A12,D1,A7
12_37_90,xcond_1,GRCm39,810,1140,1872,809,1139,1871,1,1,1,12,37,90,A12,D1,H6
12_38_15,xcond_1,GRCm39,1025,1886,3012,1025,1886,3012,0,0,0,12,38,15,A12,D2,B3
12_38_43,xcond_1,GRCm39,1099,1975,3176,1097,1973,3174,2,2,2,12,38,43,A12,D2,D7
12_38_53,xcond_1,GRCm39,711,1116,1766,711,1116,1766,0,0,0,12,38,53,A12,D2,E5
12_38_66,xcond_1,GRCm39,724,1076,1763,722,1074,1761,2,2,2,12,38,66,A12,D2,F6
12_38_96,xcond_1,GRCm39,996,1724,2701,994,1721,2697,2,3,4,12,38,96,A12,D2,H12
12_39_09,xcond_1,GRCm39,717,1166,1805,716,1165,1804,1,1,1,12,39,9,A12,D3,A9
12_39_14,xcond_1,GRCm39,281,325,503,281,325,503,0,0,0,12,39,14,A12,D3,B2
12_39_24,xcond_1,GRCm39,4236,11729,18452,4230,11720,18441,6,9,11,12,39,24,A12,D3,B12
12_39_29,xcond_1,GRCm39,427,657,1033,426,656,1031,1,1,2,12,39,29,A12,D3,C5
12_39_33,xcond_1,GRCm39,1141,2266,3551,1140,2265,3550,1,1,1,12,39,33,A12,D3,C9
12_39_63,xcond_1,GRCm39,959,1554,2373,958,1553,2372,1,1,1,12,39,63,A12,D3,F3
12_40_01,xcond_1,GRCm39,941,1519,2533,941,1519,2533,0,0,0,12,40,1,A12,D4,A1
12_40_16,xcond_1,GRCm39,722,1135,1853,721,1134,1851,1,1,2,12,40,16,A12,D4,B4
12_40_23,xcond_1,GRCm39,253,362,549,253,362,549,0,0,0,12,40,23,A12,D4,B11
12_40_53,xcond_1,GRCm39,1031,1547,2540,1029,1545,2535,2,2,5,12,40,53,A12,D4,E5
12_40_84,xcond_1,GRCm39,209,234,333,209,234,333,0,0,0,12,40,84,A12,D4,G12
12_40_92,xcond_1,GRCm39,1507,3934,6351,1503,3929,6342,4,5,9,12,40,92,A12,D4,H8
12_41_08,xcond_1,GRCm39,1471,2896,4744,1468,2893,4741,3,3,3,12,41,8,A12,D5,A8
12_41_64,xcond_1,GRCm39,603,1198,1889,602,1197,1888,1,1,1,12,41,64,A12,D5,F4
12_41_83,xcond_1,GRCm39,446,651,1045,446,651,1045,0,0,0,12,41,83,A12,D5,G11
12_42_01,xcond_1,GRCm39,871,1229,2053,869,1227,2050,2,2,3,12,42,1,A12,D6,A1
12_42_20,xcond_1,GRCm39,1019,1856,2969,1017,1854,2967,2,2,2,12,42,20,A12,D6,B8
12_42_33,xcond_1,GRCm39,904,1606,2505,901,1603,2500,3,3,5,12,42,33,A12,D6,C9
12_42_56,xcond_1,GRCm39,1098,1787,2983,1097,1786,2982,1,1,1,12,42,56,A12,D6,E8
12_43_12,xcond_1,GRCm39,1990,4161,6641,1990,4161,6641,0,0,0,12,43,12,A12,D7,A12
12_43_21,xcond_1,GRCm39,369,464,709,368,463,708,1,1,1,12,43,21,A12,D7,B9
12_43_36,xcond_1,GRCm39,859,1327,2120,859,1327,2120,0,0,0,12,43,36,A12,D7,C12
12_43_96,xcond_1,GRCm39,437,574,903,434,570,896,3,4,7,12,43,96,A12,D7,H12
12_44_41,xcond_1,GRCm39,364,441,712,364,441,712,0,0,0,12,44,41,A12,D8,D5
12_44_43,xcond_1,GRCm39,1098,1835,2954,1098,1835,2954,0,0,0,12,44,43,A12,D8,D7
12_44_66,xcond_1,GRCm39,1694,3238,5124,1694,3238,5124,0,0,0,12,44,66,A12,D8,F6
12_45_19,xcond_1,GRCm39,477,630,998,477,630,998,0,0,0,12,45,19,A12,D9,B7
12_45_31,xcond_1,GRCm39,2163,4910,7919,2163,4910,7919,0,0,0,12,45,31,A12,D9,C7
12_45_71,xcond_1,GRCm39,773,1147,1804,773,1147,1804,0,0,0,12,45,71,A12,D9,F11
12_45_89,xcond_1,GRCm39,358,484,776,358,484,776,0,0,0,12,45,89,A12,D9,H5
12_46_07,xcond_1,GRCm39,628,872,1436,627,871,1434,1,1,2,12,46,7,A12,D10,A7
12_46_14,xcond_1,GRCm39,1474,2831,4682,1472,2829,4679,2,2,3,12,46,14,A12,D10,B2
12_46_40,xcond_1,GRCm39,771,1068,1788,771,1068,1788,0,0,0,12,46,40,A12,D10,D4
12_46_83,xcond_1,GRCm39,1378,2241,3704,1376,2239,3700,2,2,4,12,46,83,A12,D10,G11
12_47_60,xcond_1,GRCm39,308,404,629,307,403,628,1,1,1,12,47,60,A12,D11,E12
12_48_09,xcond_1,GRCm39,791,1650,2652,789,1648,2650,2,2,2,12,48,9,A12,D12,A9
12_48_28,xcond_1,GRCm39,743,1277,2040,742,1276,2035,1,1,5,12,48,28,A12,D12,C4
12_48_69,xcond_1,GRCm39,530,895,1434,529,894,1433,1,1,1,12,48,69,A12,D12,F9
12_48_75,xcond_1,GRCm39,382,571,922,382,571,922,0,0,0,12,48,75,A12,D12,G3
12_49_19,xcond_1,GRCm39,410,524,854,410,524,854,0,0,0,12,49,19,A12,E1,B7
12_49_21,xcond_1,GRCm39,565,827,1395,564,826,1394,1,1,1,12,49,21,A12,E1,B9
12_49_52,xcond_1,GRCm39,1426,2332,3867,1425,2331,3866,1,1,1,12,49,52,A12,E1,E4
12_50_07,xcond_1,GRCm39,325,418,588,325,418,588,0,0,0,12,50,7,A12,E2,A7
12_50_08,xcond_1,GRCm39,5791,25451,41271,5784,25432,41246,7,19,25,12,50,8,A12,E2,A8
12_50_16,xcond_1,GRCm39,2232,4353,7024,2229,4348,7014,3,5,10,12,50,16,A12,E2,B4
12_50_19,xcond_1,GRCm39,1893,3776,6107,1890,3773,6103,3,3,4,12,50,19,A12,E2,B7
12_50_27,xcond_1,GRCm39,590,848,1330,590,848,1330,0,0,0,12,50,27,A12,E2,C3
12_50_30,xcond_1,GRCm39,1174,1734,2863,1170,1730,2858,4,4,5,12,50,30,A12,E2,C6
12_50_64,xcond_1,GRCm39,1219,2303,3702,1217,2299,3696,2,4,6,12,50,64,A12,E2,F4
12_50_65,xcond_1,GRCm39,1815,3508,5649,1812,3505,5642,3,3,7,12,50,65,A12,E2,F5
12_50_72,xcond_1,GRCm39,181,423,622,181,423,622,0,0,0,12,50,72,A12,E2,F12
12_50_76,xcond_1,GRCm39,3369,7848,12598,3364,7842,12590,5,6,8,12,50,76,A12,E2,G4
12_50_91,xcond_1,GRCm39,740,1131,1799,738,1129,1796,2,2,3,12,50,91,A12,E2,H7
12_51_78,xcond_1,GRCm39,600,847,1389,599,846,1388,1,1,1,12,51,78,A12,E3,G6
12_51_79,xcond_1,GRCm39,600,843,1414,597,840,1409,3,3,5,12,51,79,A12,E3,G7
12_52_04,xcond_1,GRCm39,602,847,1341,599,843,1336,3,4,5,12,52,4,A12,E4,A4
12_52_05,xcond_1,GRCm39,678,946,1475,677,945,1472,1,1,3,12,52,5,A12,E4,A5
12_52_17,xcond_1,GRCm39,1032,2104,3315,1031,2103,3314,1,1,1,12,52,17,A12,E4,B5
12_52_45,xcond_1,GRCm39,1103,1902,3064,1102,1901,3062,1,1,2,12,52,45,A12,E4,D9
12_52_51,xcond_1,GRCm39,938,1761,2833,937,1760,2832,1,1,1,12,52,51,A12,E4,E3
12_52_62,xcond_1,GRCm39,178,211,300,178,211,300,0,0,0,12,52,62,A12,E4,F2
12_53_31,xcond_1,GRCm39,1555,2594,4146,1554,2593,4144,1,1,2,12,53,31,A12,E5,C7
12_53_65,xcond_1,GRCm39,751,1095,1749,749,1093,1746,2,2,3,12,53,65,A12,E5,F5
12_53_91,xcond_1,GRCm39,894,1310,2194,894,1310,2194,0,0,0,12,53,91,A12,E5,H7
12_54_05,xcond_1,GRCm39,1132,2062,3317,1130,2059,3314,2,3,3,12,54,5,A12,E6,A5
12_54_39,xcond_1,GRCm39,1008,1686,2817,1007,1685,2815,1,1,2,12,54,39,A12,E6,D3
12_54_57,xcond_1,GRCm39,296,350,575,296,350,575,0,0,0,12,54,57,A12,E6,E9
12_54_60,xcond_1,GRCm39,741,1199,1930,741,1199,1930,0,0,0,12,54,60,A12,E6,E12
12_54_88,xcond_1,GRCm39,694,992,1631,694,992,1631,0,0,0,12,54,88,A12,E6,H4
12_55_39,xcond_1,GRCm39,607,1128,1748,606,1127,1746,1,1,2,12,55,39,A12,E7,D3
12_55_50,xcond_1,GRCm39,714,1061,1724,713,1059,1722,1,2,2,12,55,50,A12,E7,E2
12_55_60,xcond_1,GRCm39,438,699,1081,436,697,1078,2,2,3,12,55,60,A12,E7,E12
12_56_60,xcond_1,GRCm39,1124,1963,3139,1122,1961,3137,2,2,2,12,56,60,A12,E8,E12
12_56_71,xcond_1,GRCm39,181,227,356,180,226,355,1,1,1,12,56,71,A12,E8,F11
12_56_79,xcond_1,GRCm39,2152,4738,7610,2150,4736,7608,2,2,2,12,56,79,A12,E8,G7
12_57_20,xcond_1,GRCm39,531,762,1213,531,762,1213,0,0,0,12,57,20,A12,E9,B8
12_57_38,xcond_1,GRCm39,1712,3740,6115,1709,3736,6110,3,4,5,12,57,38,A12,E9,D2
12_57_76,xcond_1,GRCm39,1340,2220,3578,1338,2216,3570,2,4,8,12,57,76,A12,E9,G4
12_57_93,xcond_1,GRCm39,537,749,1195,537,749,1195,0,0,0,12,57,93,A12,E9,H9
12_58_16,xcond_1,GRCm39,190,242,345,190,242,345,0,0,0,12,58,16,A12,E10,B4
12_58_31,xcond_1,GRCm39,607,914,1452,607,914,1452,0,0,0,12,58,31,A12,E10,C7
12_58_33,xcond_1,GRCm39,1677,2790,4459,1674,2787,4456,3,3,3,12,58,33,A12,E10,C9
12_58_52,xcond_1,GRCm39,1117,1880,3062,1116,1879,3060,1,1,2,12,58,52,A12,E10,E4
12_58_81,xcond_1,GRCm39,483,601,936,483,601,936,0,0,0,12,58,81,A12,E10,G9
12_59_04,xcond_1,GRCm39,438,563,869,437,562,868,1,1,1,12,59,4,A12,E11,A4
12_59_20,xcond_1,GRCm39,1901,3455,5530,1898,3452,5523,3,3,7,12,59,20,A12,E11,B8
12_59_44,xcond_1,GRCm39,1185,2365,3833,1182,2362,3829,3,3,4,12,59,44,A12,E11,D8
12_59_66,xcond_1,GRCm39,2735,7015,11202,2733,7013,11200,2,2,2,12,59,66,A12,E11,F6
12_59_86,xcond_1,GRCm39,1858,3806,6090,1857,3805,6089,1,1,1,12,59,86,A12,E11,H2
12_61_11,xcond_1,GRCm39,1571,3439,5477,1570,3438,5476,1,1,1,12,61,11,A12,F1,A11
12_61_20,xcond_1,GRCm39,260,354,544,260,354,544,0,0,0,12,61,20,A12,F1,B8
12_62_51,xcond_1,GRCm39,4085,11365,18719,4080,11354,18699,5,11,20,12,62,51,A12,F2,E3
12_62_69,xcond_1,GRCm39,679,1038,1675,679,1038,1675,0,0,0,12,62,69,A12,F2,F9
12_62_95,xcond_1,GRCm39,3075,8386,13672,3071,8375,13653,4,11,19,12,62,95,A12,F2,H11
12_63_04,xcond_1,GRCm39,2484,5096,8290,2480,5089,8280,4,7,10,12,63,4,A12,F3,A4
12_63_24,xcond_1,GRCm39,216,258,382,216,258,382,0,0,0,12,63,24,A12,F3,B12
12_63_69,xcond_1,GRCm39,734,1127,1850,734,1127,1850,0,0,0,12,63,69,A12,F3,F9
12_63_74,xcond_1,GRCm39,1916,4307,6999,1915,4305,6996,1,2,3,12,63,74,A12,F3,G2
12_64_72,xcond_1,GRCm39,4358,14082,23555,4354,14076,23549,4,6,6,12,64,72,A12,F4,F12
12_64_84,xcond_1,GRCm39,2702,6024,10081,2698,6019,10074,4,5,7,12,64,84,A12,F4,G12
12_65_20,xcond_1,GRCm39,1713,3593,5906,1711,3590,5903,2,3,3,12,65,20,A12,F5,B8
12_65_28,xcond_1,GRCm39,674,1041,1792,673,1040,1791,1,1,1,12,65,28,A12,F5,C4
12_65_50,xcond_1,GRCm39,1949,4257,7071,1946,4252,7065,3,5,6,12,65,50,A12,F5,E2
12_65_72,xcond_1,GRCm39,1480,2964,5017,1479,2962,5015,1,2,2,12,65,72,A12,F5,F12
12_66_47,xcond_1,GRCm39,662,851,1417,661,850,1414,1,1,3,12,66,47,A12,F6,D11
12_66_66,xcond_1,GRCm39,211,247,375,210,246,374,1,1,1,12,66,66,A12,F6,F6
12_66_96,xcond_1,GRCm39,169,215,363,168,214,362,1,1,1,12,66,96,A12,F6,H12
12_67_19,xcond_1,GRCm39,686,1152,1874,685,1151,1873,1,1,1,12,67,19,A12,F7,B7
12_67_26,xcond_1,GRCm39,1041,1671,2751,1039,1669,2744,2,2,7,12,67,26,A12,F7,C2
12_67_36,xcond_1,GRCm39,1902,3662,6084,1900,3659,6077,2,3,7,12,67,36,A12,F7,C12
12_67_77,xcond_1,GRCm39,673,1041,1700,672,1039,1697,1,2,3,12,67,77,A12,F7,G5
12_67_96,xcond_1,GRCm39,1432,2235,3579,1430,2233,3575,2,2,4,12,67,96,A12,F7,H12
12_68_33,xcond_1,GRCm39,771,1080,1742,771,1080,1742,0,0,0,12,68,33,A12,F8,C9
12_68_39,xcond_1,GRCm39,1465,2798,4575,1464,2797,4571,1,1,4,12,68,39,A12,F8,D3
12_68_41,xcond_1,GRCm39,1101,3718,5958,1098,3714,5954,3,4,4,12,68,41,A12,F8,D5
12_68_69,xcond_1,GRCm39,703,947,1552,702,946,1551,1,1,1,12,68,69,A12,F8,F9
12_68_80,xcond_1,GRCm39,817,1514,2444,816,1513,2443,1,1,1,12,68,80,A12,F8,G8
12_68_83,xcond_1,GRCm39,828,1280,2075,828,1280,2075,0,0,0,12,68,83,A12,F8,G11
12_68_87,xcond_1,GRCm39,846,1509,2390,846,1509,2390,0,0,0,12,68,87,A12,F8,H3
12_68_89,xcond_1,GRCm39,855,1425,2275,854,1424,2274,1,1,1,12,68,89,A12,F8,H5
12_69_11,xcond_1,GRCm39,509,809,1234,508,807,1231,1,2,3,12,69,11,A12,F9,A11
12_69_21,xcond_1,GRCm39,686,1087,1736,686,1087,1736,0,0,0,12,69,21,A12,F9,B9
12_69_41,xcond_1,GRCm39,262,349,506,262,349,506,0,0,0,12,69,41,A12,F9,D5
12_69_51,xcond_1,GRCm39,1421,2406,3852,1420,2404,3849,1,2,3,12,69,51,A12,F9,E3
12_69_69,xcond_1,GRCm39,413,538,852,412,537,851,1,1,1,12,69,69,A12,F9,F9
12_69_80,xcond_1,GRCm39,509,648,1043,507,645,1038,2,3,5,12,69,80,A12,F9,G8
12_69_92,xcond_1,GRCm39,2013,4279,6870,2012,4277,6867,1,2,3,12,69,92,A12,F9,H8
12_70_19,xcond_1,GRCm39,947,1512,2382,947,1512,2382,0,0,0,12,70,19,A12,F10,B7
12_70_28,xcond_1,GRCm39,381,484,767,381,484,767,0,0,0,12,70,28,A12,F10,C4
12_70_36,xcond_1,GRCm39,895,1476,2346,894,1475,2345,1,1,1,12,70,36,A12,F10,C12
12_70_95,xcond_1,GRCm39,840,1305,2091,840,1305,2091,0,0,0,12,70,95,A12,F10,H11
12_71_11,xcond_1,GRCm39,1277,2777,4410,1276,2776,4409,1,1,1,12,71,11,A12,F11,A11
12_71_15,xcond_1,GRCm39,267,423,628,267,423,628,0,0,0,12,71,15,A12,F11,B3
12_72_28,xcond_1,GRCm39,341,554,898,341,554,898,0,0,0,12,72,28,A12,F12,C4
12_72_33,xcond_1,GRCm39,1949,3636,5849,1948,3635,5848,1,1,1,12,72,33,A12,F12,C9
12_73_15,xcond_1,GRCm39,865,1488,2387,864,1487,2386,1,1,1,12,73,15,A12,G1,B3
12_73_20,xcond_1,GRCm39,578,908,1447,576,906,1443,2,2,4,12,73,20,A12,G1,B8
12_73_45,xcond_1,GRCm39,511,679,1100,511,679,1100,0,0,0,12,73,45,A12,G1,D9
12_73_60,xcond_1,GRCm39,1242,2364,3836,1239,2360,3825,3,4,11,12,73,60,A12,G1,E12
12_74_17,xcond_1,GRCm39,1273,2382,3864,1273,2382,3864,0,0,0,12,74,17,A12,G2,B5
12_74_19,xcond_1,GRCm39,904,1559,2470,903,1558,2468,1,1,2,12,74,19,A12,G2,B7
12_74_29,xcond_1,GRCm39,1062,1733,2790,1062,1733,2790,0,0,0,12,74,29,A12,G2,C5
12_74_33,xcond_1,GRCm39,519,671,1061,518,670,1060,1,1,1,12,74,33,A12,G2,C9
12_74_47,xcond_1,GRCm39,1092,1758,2799,1090,1756,2796,2,2,3,12,74,47,A12,G2,D11
12_74_50,xcond_1,GRCm39,725,969,1589,723,967,1586,2,2,3,12,74,50,A12,G2,E2
12_74_51,xcond_1,GRCm39,1132,1696,2697,1132,1696,2697,0,0,0,12,74,51,A12,G2,E3
12_74_61,xcond_1,GRCm39,862,1323,2108,860,1321,2104,2,2,4,12,74,61,A12,G2,F1
12_74_75,xcond_1,GRCm39,469,605,962,469,605,962,0,0,0,12,74,75,A12,G2,G3
12_74_80,xcond_1,GRCm39,2399,5301,8558,2397,5298,8549,2,3,9,12,74,80,A12,G2,G8
12_74_91,xcond_1,GRCm39,167,226,322,167,226,322,0,0,0,12,74,91,A12,G2,H7
12_74_93,xcond_1,GRCm39,190,211,319,190,211,319,0,0,0,12,74,93,A12,G2,H9
12_75_17,xcond_1,GRCm39,299,378,606,299,378,606,0,0,0,12,75,17,A12,G3,B5
12_75_19,xcond_1,GRCm39,1033,1625,2630,1033,1625,2630,0,0,0,12,75,19,A12,G3,B7
12_75_21,xcond_1,GRCm39,885,1483,2368,885,1483,2368,0,0,0,12,75,21,A12,G3,B9
12_75_24,xcond_1,GRCm39,1370,2613,4179,1369,2612,4178,1,1,1,12,75,24,A12,G3,B12
12_75_35,xcond_1,GRCm39,1869,4093,6633,1868,4091,6631,1,2,2,12,75,35,A12,G3,C11
12_75_45,xcond_1,GRCm39,749,1180,1917,747,1178,1914,2,2,3,12,75,45,A12,G3,D9
12_75_56,xcond_1,GRCm39,863,1349,2156,860,1346,2153,3,3,3,12,75,56,A12,G3,E8
12_75_64,xcond_1,GRCm39,477,624,979,477,624,979,0,0,0,12,75,64,A12,G3,F4
12_75_66,xcond_1,GRCm39,310,406,655,310,406,655,0,0,0,12,75,66,A12,G3,F6
12_75_86,xcond_1,GRCm39,913,1684,2756,912,1683,2755,1,1,1,12,75,86,A12,G3,H2
12_76_13,xcond_1,GRCm39,597,863,1391,597,863,1391,0,0,0,12,76,13,A12,G4,B1
12_76_21,xcond_1,GRCm39,696,1009,1649,696,1009,1649,0,0,0,12,76,21,A12,G4,B9
12_76_24,xcond_1,GRCm39,1149,1847,3036,1149,1847,3036,0,0,0,12,76,24,A12,G4,B12
12_76_37,xcond_1,GRCm39,2886,5999,9658,2882,5995,9650,4,4,8,12,76,37,A12,G4,D1
12_76_93,xcond_1,GRCm39,615,929,1579,615,929,1579,0,0,0,12,76,93,A12,G4,H9
12_77_51,xcond_1,GRCm39,943,1731,2765,942,1730,2764,1,1,1,12,77,51,A12,G5,E3
12_77_92,xcond_1,GRCm39,993,1746,2778,993,1746,2778,0,0,0,12,77,92,A12,G5,H8
12_78_18,xcond_1,GRCm39,985,1986,3205,983,1984,3203,2,2,2,12,78,18,A12,G6,B6
12_78_37,xcond_1,GRCm39,928,1537,2523,926,1535,2519,2,2,4,12,78,37,A12,G6,D1
12_78_39,xcond_1,GRCm39,491,619,1056,490,618,1055,1,1,1,12,78,39,A12,G6,D3
12_78_40,xcond_1,GRCm39,1095,2040,3271,1093,2038,3269,2,2,2,12,78,40,A12,G6,D4
12_78_49,xcond_1,GRCm39,482,714,1159,480,712,1157,2,2,2,12,78,49,A12,G6,E1
12_78_60,xcond_1,GRCm39,470,644,1033,470,644,1033,0,0,0,12,78,60,A12,G6,E12
12_78_62,xcond_1,GRCm39,85,257,396,85,257,396,0,0,0,12,78,62,A12,G6,F2
12_79_04,xcond_1,GRCm39,817,1109,1839,815,1107,1837,2,2,2,12,79,4,A12,G7,A4
12_79_27,xcond_1,GRCm39,1048,1727,2741,1046,1724,2737,2,3,4,12,79,27,A12,G7,C3
12_79_32,xcond_1,GRCm39,1019,1919,3143,1019,1919,3143,0,0,0,12,79,32,A12,G7,C8
12_79_44,xcond_1,GRCm39,1774,2989,4881,1773,2988,4880,1,1,1,12,79,44,A12,G7,D8
12_81_36,xcond_1,GRCm39,227,287,422,227,287,422,0,0,0,12,81,36,A12,G9,C12
12_81_42,xcond_1,GRCm39,1100,1875,3104,1098,1871,3099,2,4,5,12,81,42,A12,G9,D6
12_81_59,xcond_1,GRCm39,2156,5577,8818,2151,5565,8802,5,12,16,12,81,59,A12,G9,E11
12_81_60,xcond_1,GRCm39,2253,5045,8128,2251,5043,8126,2,2,2,12,81,60,A12,G9,E12
12_81_81,xcond_1,GRCm39,638,937,1501,638,937,1501,0,0,0,12,81,81,A12,G9,G9
12_81_83,xcond_1,GRCm39,480,635,1003,480,635,1003,0,0,0,12,81,83,A12,G9,G11
12_82_02,xcond_1,GRCm39,917,1500,2432,916,1499,2430,1,1,2,12,82,2,A12,G10,A2
12_82_31,xcond_1,GRCm39,694,1176,1879,694,1176,1879,0,0,0,12,82,31,A12,G10,C7
12_82_53,xcond_1,GRCm39,218,290,456,218,290,456,0,0,0,12,82,53,A12,G10,E5
12_82_88,xcond_1,GRCm39,770,1161,1870,770,1161,1870,0,0,0,12,82,88,A12,G10,H4
12_82_96,xcond_1,GRCm39,85,295,435,73,283,414,12,12,21,12,82,96,A12,G10,H12
12_83_29,xcond_1,GRCm39,673,1026,1670,673,1026,1670,0,0,0,12,83,29,A12,G11,C5
12_83_87,xcond_1,GRCm39,599,814,1367,598,812,1364,1,2,3,12,83,87,A12,G11,H3
12_83_88,xcond_1,GRCm39,212,266,414,210,264,409,2,2,5,12,83,88,A12,G11,H4
12_83_95,xcond_1,GRCm39,216,258,400,216,258,400,0,0,0,12,83,95,A12,G11,H11
12_84_84,xcond_1,GRCm39,1875,3818,6100,1874,3816,6097,1,2,3,12,84,84,A12,G12,G12
12_85_23,xcond_1,GRCm39,1671,3224,5072,1671,3224,5072,0,0,0,12,85,23,A12,H1,B11
12_85_24,xcond_1,GRCm39,201,234,357,201,234,357,0,0,0,12,85,24,A12,H1,B12
12_85_57,xcond_1,GRCm39,454,663,1065,453,662,1064,1,1,1,12,85,57,A12,H1,E9
12_85_72,xcond_1,GRCm39,1727,3163,5127,1726,3162,5125,1,1,2,12,85,72,A12,H1,F12
12_86_02,xcond_1,GRCm39,565,848,1377,565,848,1377,0,0,0,12,86,2,A12,H2,A2
12_87_24,xcond_1,GRCm39,927,1243,1945,926,1242,1943,1,1,2,12,87,24,A12,H3,B12
12_87_53,xcond_1,GRCm39,740,1063,1669,739,1062,1668,1,1,1,12,87,53,A12,H3,E5
12_87_57,xcond_1,GRCm39,1722,3642,5685,1722,3642,5685,0,0,0,12,87,57,A12,H3,E9
12_87_72,xcond_1,GRCm39,666,1135,1746,665,1134,1745,1,1,1,12,87,72,A12,H3,F12
12_87_77,xcond_1,GRCm39,936,1367,2155,935,1366,2153,1,1,2,12,87,77,A12,H3,G5
12_87_84,xcond_1,GRCm39,1990,3948,6291,1990,3948,6291,0,0,0,12,87,84,A12,H3,G12
12_87_88,xcond_1,GRCm39,497,729,1142,497,729,1142,0,0,0,12,87,88,A12,H3,H4
12_88_03,xcond_1,GRCm39,1027,2081,3329,1026,2080,3326,1,1,3,12,88,3,A12,H4,A3
12_88_07,xcond_1,GRCm39,666,885,1378,665,883,1376,1,2,2,12,88,7,A12,H4,A7
12_89_12,xcond_1,GRCm39,199,250,404,199,250,404,0,0,0,12,89,12,A12,H5,A12
12_89_55,xcond_1,GRCm39,2166,4531,7224,2162,4525,7211,4,6,13,12,89,55,A12,H5,E7
12_90_44,xcond_1,GRCm39,1724,3172,5310,1722,3170,5307,2,2,3,12,90,44,A12,H6,D8
12_90_65,xcond_1,GRCm39,796,1199,1993,795,1198,1992,1,1,1,12,90,65,A12,H6,F5
12_90_67,xcond_1,GRCm39,957,1891,3066,956,1890,3063,1,1,3,12,90,67,A12,H6,F7
12_90_80,xcond_1,GRCm39,735,1003,1618,735,1003,1618,0,0,0,12,90,80,A12,H6,G8
12_90_85,xcond_1,GRCm39,853,1309,2177,853,1309,2177,0,0,0,12,90,85,A12,H6,H1
12_91_12,xcond_1,GRCm39,708,1013,1630,707,1012,1629,1,1,1,12,91,12,A12,H7,A12
12_91_19,xcond_1,GRCm39,679,942,1550,678,941,1549,1,1,1,12,91,19,A12,H7,B7
12_91_49,xcond_1,GRCm39,2263,4785,7818,2258,4779,7806,5,6,12,12,91,49,A12,H7,E1
12_91_57,xcond_1,GRCm39,636,982,1650,636,982,1650,0,0,0,12,91,57,A12,H7,E9
12_91_73,xcond_1,GRCm39,282,764,1251,281,763,1250,1,1,1,12,91,73,A12,H7,G1
12_92_09,xcond_1,GRCm39,440,561,931,440,561,931,0,0,0,12,92,9,A12,H8,A9
12_92_40,xcond_1,GRCm39,655,1086,1680,655,1086,1680,0,0,0,12,92,40,A12,H8,D4
12_92_77,xcond_1,GRCm39,1725,3627,5916,1724,3626,5913,1,1,3,12,92,77,A12,H8,G5
12_92_86,xcond_1,GRCm39,620,884,1459,619,883,1458,1,1,1,12,92,86,A12,H8,H2
12_93_19,xcond_1,GRCm39,1197,2258,3596,1196,2257,3594,1,1,2,12,93,19,A12,H9,B7
12_93_77,xcond_1,GRCm39,1052,1769,2800,1050,1766,2797,2,3,3,12,93,77,A12,H9,G5
12_93_79,xcond_1,GRCm39,1274,2429,3985,1273,2428,3983,1,1,2,12,93,79,A12,H9,G7
12_93_80,xcond_1,GRCm39,424,647,987,424,647,987,0,0,0,12,93,80,A12,H9,G8
12_93_84,xcond_1,GRCm39,325,446,687,325,446,687,0,0,0,12,93,84,A12,H9,G12
12_93_89,xcond_1,GRCm39,1939,4091,6567,1938,4090,6566,1,1,1,12,93,89,A12,H9,H5
12_94_06,xcond_1,GRCm39,439,537,890,438,536,888,1,1,2,12,94,6,A12,H10,A6
12_94_28,xcond_1,GRCm39,598,1056,1667,597,1055,1666,1,1,1,12,94,28,A12,H10,C4
12_94_73,xcond_1,GRCm39,1231,2133,3495,1229,2131,3492,2,2,3,12,94,73,A12,H10,G1
12_94_74,xcond_1,GRCm39,945,1475,2403,942,1472,2397,3,3,6,12,94,74,A12,H10,G2
12_94_79,xcond_1,GRCm39,1467,2607,4210,1466,2606,4208,1,1,2,12,94,79,A12,H10,G7
12_95_19,xcond_1,GRCm39,1355,2355,3798,1355,2355,3798,0,0,0,12,95,19,A12,H11,B7
12_95_49,xcond_1,GRCm39,918,1377,2224,916,1375,2222,2,2,2,12,95,49,A12,H11,E1
12_95_65,xcond_1,GRCm39,1043,1726,2886,1043,1726,2886,0,0,0,12,95,65,A12,H11,F5
12_96_92,xcond_1,GRCm39,610,862,1443,609,861,1441,1,1,2,12,96,92,A12,H12,H8
